file_id,object_name,result_id,model_id,flower_box_id,flower_class,flower_score,flower_name,width,height,x0,y0,x1,y1
2,0344-6782/2021-06-21/08/0344-6782_2021-06-21T08-15-51Z.jpg,490,CONFIG002,0,0,0.9158868789672852,daisy,82,93,1130,924,1212,1017
2,0344-6782/2021-06-21/08/0344-6782_2021-06-21T08-15-51Z.jpg,490,CONFIG002,1,0,0.9139392971992493,daisy,97,101,1235,1046,1332,1147
2,0344-6782/2021-06-21/08/0344-6782_2021-06-21T08-15-51Z.jpg,490,CONFIG002,2,0,0.9123879671096802,daisy,93,98,667,796,760,894
2,0344-6782/2021-06-21/08/0344-6782_2021-06-21T08-15-51Z.jpg,490,CONFIG002,3,0,0.9103153347969055,daisy,95,86,1134,535,1229,621
2,0344-6782/2021-06-21/08/0344-6782_2021-06-21T08-15-51Z.jpg,490,CONFIG002,4,0,0.9069498181343079,daisy,82,78,793,602,875,680
2,0344-6782/2021-06-21/08/0344-6782_2021-06-21T08-15-51Z.jpg,490,CONFIG002,5,0,0.9067599177360535,daisy,96,100,841,675,937,775
2,0344-6782/2021-06-21/08/0344-6782_2021-06-21T08-15-51Z.jpg,490,CONFIG002,6,0,0.9056529402732849,daisy,100,100,1379,963,1479,1063
2,0344-6782/2021-06-21/08/0344-6782_2021-06-21T08-15-51Z.jpg,490,CONFIG002,7,0,0.902245283126831,daisy,86,76,1312,363,1398,439
2,0344-6782/2021-06-21/08/0344-6782_2021-06-21T08-15-51Z.jpg,490,CONFIG002,8,0,0.9007219672203064,daisy,88,81,1187,340,1275,421
2,0344-6782/2021-06-21/08/0344-6782_2021-06-21T08-15-51Z.jpg,490,CONFIG002,9,0,0.8989468812942505,daisy,87,102,961,959,1048,1061
2,0344-6782/2021-06-21/08/0344-6782_2021-06-21T08-15-51Z.jpg,490,CONFIG002,10,0,0.8984769582748413,daisy,89,83,1404,645,1493,728
2,0344-6782/2021-06-21/08/0344-6782_2021-06-21T08-15-51Z.jpg,490,CONFIG002,11,0,0.8947130441665649,daisy,81,83,1219,249,1300,332
2,0344-6782/2021-06-21/08/0344-6782_2021-06-21T08-15-51Z.jpg,490,CONFIG002,12,0,0.8937216401100159,daisy,80,79,854,889,934,968
2,0344-6782/2021-06-21/08/0344-6782_2021-06-21T08-15-51Z.jpg,490,CONFIG002,13,0,0.89158695936203,daisy,78,86,975,868,1053,954
2,0344-6782/2021-06-21/08/0344-6782_2021-06-21T08-15-51Z.jpg,490,CONFIG002,14,0,0.8884409070014954,daisy,92,80,1136,430,1228,510
2,0344-6782/2021-06-21/08/0344-6782_2021-06-21T08-15-51Z.jpg,490,CONFIG002,15,0,0.8878256678581238,daisy,79,88,879,836,958,924
2,0344-6782/2021-06-21/08/0344-6782_2021-06-21T08-15-51Z.jpg,490,CONFIG002,16,0,0.8871692419052124,daisy,83,77,1280,524,1363,601
2,0344-6782/2021-06-21/08/0344-6782_2021-06-21T08-15-51Z.jpg,490,CONFIG002,17,0,0.8863510489463806,daisy,99,97,1222,616,1321,713
2,0344-6782/2021-06-21/08/0344-6782_2021-06-21T08-15-51Z.jpg,490,CONFIG002,18,0,0.867819607257843,daisy,87,85,1330,632,1417,717
2,0344-6782/2021-06-21/08/0344-6782_2021-06-21T08-15-51Z.jpg,490,CONFIG002,19,0,0.8667883276939392,daisy,70,75,1125,603,1195,678
2,0344-6782/2021-06-21/08/0344-6782_2021-06-21T08-15-51Z.jpg,490,CONFIG002,20,0,0.8414562344551086,daisy,77,78,1082,612,1159,690
2,0344-6782/2021-06-21/08/0344-6782_2021-06-21T08-15-51Z.jpg,490,CONFIG002,21,0,0.8404656648635864,daisy,67,67,1221,401,1288,468
2,0344-6782/2021-06-21/08/0344-6782_2021-06-21T08-15-51Z.jpg,490,CONFIG002,22,0,0.813133716583252,daisy,67,65,1017,687,1084,752
2,0344-6782/2021-06-21/08/0344-6782_2021-06-21T08-15-51Z.jpg,490,CONFIG002,23,0,0.5461034178733826,daisy,57,60,1002,696,1059,756
2,0344-6782/2021-06-21/08/0344-6782_2021-06-21T08-15-51Z.jpg,490,CONFIG002,24,0,0.5257903933525085,daisy,75,59,1087,586,1162,645
3,0344-6782/2021-06-21/08/0344-6782_2021-06-21T08-52-41Z.jpg,491,CONFIG002,0,0,0.920586884021759,daisy,95,99,844,680,939,779
3,0344-6782/2021-06-21/08/0344-6782_2021-06-21T08-52-41Z.jpg,491,CONFIG002,1,0,0.9035160541534424,daisy,80,80,1219,253,1299,333
3,0344-6782/2021-06-21/08/0344-6782_2021-06-21T08-52-41Z.jpg,491,CONFIG002,2,0,0.903154194355011,daisy,97,98,1244,1048,1341,1146
3,0344-6782/2021-06-21/08/0344-6782_2021-06-21T08-52-41Z.jpg,491,CONFIG002,3,0,0.9004656076431274,daisy,84,79,793,615,877,694
3,0344-6782/2021-06-21/08/0344-6782_2021-06-21T08-52-41Z.jpg,491,CONFIG002,4,0,0.8991906046867371,daisy,89,79,1186,347,1275,426
3,0344-6782/2021-06-21/08/0344-6782_2021-06-21T08-52-41Z.jpg,491,CONFIG002,5,0,0.8990898132324219,daisy,101,101,671,802,772,903
3,0344-6782/2021-06-21/08/0344-6782_2021-06-21T08-52-41Z.jpg,491,CONFIG002,6,0,0.8973701000213623,daisy,82,75,1325,369,1407,444
3,0344-6782/2021-06-21/08/0344-6782_2021-06-21T08-52-41Z.jpg,491,CONFIG002,7,0,0.8971853852272034,daisy,88,82,1274,527,1362,609
3,0344-6782/2021-06-21/08/0344-6782_2021-06-21T08-52-41Z.jpg,491,CONFIG002,8,0,0.8963897824287415,daisy,93,87,1139,541,1232,628
3,0344-6782/2021-06-21/08/0344-6782_2021-06-21T08-52-41Z.jpg,491,CONFIG002,9,0,0.8954135775566101,daisy,80,81,854,888,934,969
3,0344-6782/2021-06-21/08/0344-6782_2021-06-21T08-52-41Z.jpg,491,CONFIG002,10,0,0.8951836228370667,daisy,85,85,1334,639,1419,724
3,0344-6782/2021-06-21/08/0344-6782_2021-06-21T08-52-41Z.jpg,491,CONFIG002,11,0,0.8951083421707153,daisy,78,85,977,869,1055,954
3,0344-6782/2021-06-21/08/0344-6782_2021-06-21T08-52-41Z.jpg,491,CONFIG002,12,0,0.8936221599578857,daisy,99,100,1380,962,1479,1062
3,0344-6782/2021-06-21/08/0344-6782_2021-06-21T08-52-41Z.jpg,491,CONFIG002,13,0,0.8930125832557678,daisy,88,85,1406,653,1494,738
3,0344-6782/2021-06-21/08/0344-6782_2021-06-21T08-52-41Z.jpg,491,CONFIG002,14,0,0.891132652759552,daisy,84,90,1133,922,1217,1012
3,0344-6782/2021-06-21/08/0344-6782_2021-06-21T08-52-41Z.jpg,491,CONFIG002,15,0,0.8851479291915894,daisy,81,100,962,957,1043,1057
3,0344-6782/2021-06-21/08/0344-6782_2021-06-21T08-52-41Z.jpg,491,CONFIG002,16,0,0.8797563314437866,daisy,95,94,1226,624,1321,718
3,0344-6782/2021-06-21/08/0344-6782_2021-06-21T08-52-41Z.jpg,491,CONFIG002,17,0,0.85885089635849,daisy,84,91,877,835,961,926
3,0344-6782/2021-06-21/08/0344-6782_2021-06-21T08-52-41Z.jpg,491,CONFIG002,18,0,0.8455101847648621,daisy,72,66,1218,406,1290,472
3,0344-6782/2021-06-21/08/0344-6782_2021-06-21T08-52-41Z.jpg,491,CONFIG002,19,0,0.8233290314674377,daisy,70,80,1127,606,1197,686
3,0344-6782/2021-06-21/08/0344-6782_2021-06-21T08-52-41Z.jpg,491,CONFIG002,20,0,0.814354419708252,daisy,78,78,1082,616,1160,694
3,0344-6782/2021-06-21/08/0344-6782_2021-06-21T08-52-41Z.jpg,491,CONFIG002,21,0,0.8030577301979065,daisy,66,63,1017,687,1083,750
3,0344-6782/2021-06-21/08/0344-6782_2021-06-21T08-52-41Z.jpg,491,CONFIG002,22,0,0.7579126954078674,daisy,81,75,1058,371,1139,446
3,0344-6782/2021-06-21/08/0344-6782_2021-06-21T08-52-41Z.jpg,491,CONFIG002,23,0,0.7172964811325073,daisy,83,75,1145,448,1228,523
3,0344-6782/2021-06-21/08/0344-6782_2021-06-21T08-52-41Z.jpg,491,CONFIG002,24,0,0.6509442925453186,daisy,79,71,1154,428,1233,499
3,0344-6782/2021-06-21/08/0344-6782_2021-06-21T08-52-41Z.jpg,491,CONFIG002,25,0,0.5517116785049438,daisy,63,75,1218,860,1281,935
4,0344-6782/2021-06-21/08/0344-6782_2021-06-21T08-35-34Z.jpg,492,CONFIG002,0,0,0.9298091530799866,daisy,83,95,1130,924,1213,1019
4,0344-6782/2021-06-21/08/0344-6782_2021-06-21T08-35-34Z.jpg,492,CONFIG002,1,0,0.921325147151947,daisy,95,98,845,680,940,778
4,0344-6782/2021-06-21/08/0344-6782_2021-06-21T08-35-34Z.jpg,492,CONFIG002,2,0,0.9100663661956787,daisy,84,74,1320,366,1404,440
4,0344-6782/2021-06-21/08/0344-6782_2021-06-21T08-35-34Z.jpg,492,CONFIG002,3,0,0.9091464877128601,daisy,100,101,670,803,770,904
4,0344-6782/2021-06-21/08/0344-6782_2021-06-21T08-35-34Z.jpg,492,CONFIG002,4,0,0.9033499956130981,daisy,75,85,978,871,1053,956
4,0344-6782/2021-06-21/08/0344-6782_2021-06-21T08-35-34Z.jpg,492,CONFIG002,5,0,0.9027892351150513,daisy,83,79,794,611,877,690
4,0344-6782/2021-06-21/08/0344-6782_2021-06-21T08-35-34Z.jpg,492,CONFIG002,6,0,0.9024926424026489,daisy,79,80,856,891,935,971
4,0344-6782/2021-06-21/08/0344-6782_2021-06-21T08-35-34Z.jpg,492,CONFIG002,7,0,0.9023496508598328,daisy,86,101,961,961,1047,1062
4,0344-6782/2021-06-21/08/0344-6782_2021-06-21T08-35-34Z.jpg,492,CONFIG002,8,0,0.9011936783790588,daisy,97,99,1380,965,1477,1064
4,0344-6782/2021-06-21/08/0344-6782_2021-06-21T08-35-34Z.jpg,492,CONFIG002,9,0,0.9007523655891418,daisy,87,84,1407,651,1494,735
4,0344-6782/2021-06-21/08/0344-6782_2021-06-21T08-35-34Z.jpg,492,CONFIG002,10,0,0.9005246758460999,daisy,87,81,1278,526,1365,607
4,0344-6782/2021-06-21/08/0344-6782_2021-06-21T08-35-34Z.jpg,492,CONFIG002,11,0,0.9002285003662109,daisy,89,80,1190,345,1279,425
4,0344-6782/2021-06-21/08/0344-6782_2021-06-21T08-35-34Z.jpg,492,CONFIG002,12,0,0.898999035358429,daisy,88,83,1336,640,1424,723
4,0344-6782/2021-06-21/08/0344-6782_2021-06-21T08-35-34Z.jpg,492,CONFIG002,13,0,0.8982221484184265,daisy,78,81,1222,252,1300,333
4,0344-6782/2021-06-21/08/0344-6782_2021-06-21T08-35-34Z.jpg,492,CONFIG002,14,0,0.8951330780982971,daisy,94,87,1139,539,1233,626
4,0344-6782/2021-06-21/08/0344-6782_2021-06-21T08-35-34Z.jpg,492,CONFIG002,15,0,0.891951858997345,daisy,96,99,1241,1047,1337,1146
4,0344-6782/2021-06-21/08/0344-6782_2021-06-21T08-35-34Z.jpg,492,CONFIG002,16,0,0.8862062692642212,daisy,96,95,1227,623,1323,718
4,0344-6782/2021-06-21/08/0344-6782_2021-06-21T08-35-34Z.jpg,492,CONFIG002,17,0,0.869464099407196,daisy,71,66,1217,405,1288,471
4,0344-6782/2021-06-21/08/0344-6782_2021-06-21T08-35-34Z.jpg,492,CONFIG002,18,0,0.8579655885696411,daisy,94,87,1140,432,1234,519
4,0344-6782/2021-06-21/08/0344-6782_2021-06-21T08-35-34Z.jpg,492,CONFIG002,19,0,0.8468046188354492,daisy,79,89,881,837,960,926
4,0344-6782/2021-06-21/08/0344-6782_2021-06-21T08-35-34Z.jpg,492,CONFIG002,20,0,0.8250265121459961,daisy,77,77,1083,616,1160,693
4,0344-6782/2021-06-21/08/0344-6782_2021-06-21T08-35-34Z.jpg,492,CONFIG002,21,0,0.8237228989601135,daisy,68,64,1016,687,1084,751
4,0344-6782/2021-06-21/08/0344-6782_2021-06-21T08-35-34Z.jpg,492,CONFIG002,22,0,0.8126229047775269,daisy,69,82,1128,603,1197,685
4,0344-6782/2021-06-21/08/0344-6782_2021-06-21T08-35-34Z.jpg,492,CONFIG002,23,0,0.5403947830200195,daisy,77,67,1084,584,1161,651
5,0344-6782/2021-06-21/08/0344-6782_2021-06-21T08-42-47Z.jpg,493,CONFIG002,0,0,0.9184143543243408,daisy,95,99,844,679,939,778
5,0344-6782/2021-06-21/08/0344-6782_2021-06-21T08-42-47Z.jpg,493,CONFIG002,1,0,0.906278669834137,daisy,99,97,671,799,770,896
5,0344-6782/2021-06-21/08/0344-6782_2021-06-21T08-42-47Z.jpg,493,CONFIG002,2,0,0.903243362903595,daisy,83,78,794,611,877,689
5,0344-6782/2021-06-21/08/0344-6782_2021-06-21T08-42-47Z.jpg,493,CONFIG002,3,0,0.9022861123085022,daisy,80,81,1219,251,1299,332
5,0344-6782/2021-06-21/08/0344-6782_2021-06-21T08-42-47Z.jpg,493,CONFIG002,4,0,0.9016154408454895,daisy,92,86,1137,539,1229,625
5,0344-6782/2021-06-21/08/0344-6782_2021-06-21T08-42-47Z.jpg,493,CONFIG002,5,0,0.8993149399757385,daisy,79,84,977,870,1056,954
5,0344-6782/2021-06-21/08/0344-6782_2021-06-21T08-42-47Z.jpg,493,CONFIG002,6,0,0.8973947167396545,daisy,82,73,1324,368,1406,441
5,0344-6782/2021-06-21/08/0344-6782_2021-06-21T08-42-47Z.jpg,493,CONFIG002,7,0,0.8972856998443604,daisy,89,81,1186,343,1275,424
5,0344-6782/2021-06-21/08/0344-6782_2021-06-21T08-42-47Z.jpg,493,CONFIG002,8,0,0.895972728729248,daisy,79,80,855,889,934,969
5,0344-6782/2021-06-21/08/0344-6782_2021-06-21T08-42-47Z.jpg,493,CONFIG002,9,0,0.8939805626869202,daisy,87,80,1276,526,1363,606
5,0344-6782/2021-06-21/08/0344-6782_2021-06-21T08-42-47Z.jpg,493,CONFIG002,10,0,0.8937252759933472,daisy,97,98,1243,1048,1340,1146
5,0344-6782/2021-06-21/08/0344-6782_2021-06-21T08-42-47Z.jpg,493,CONFIG002,11,0,0.8907500505447388,daisy,87,93,1128,922,1215,1015
5,0344-6782/2021-06-21/08/0344-6782_2021-06-21T08-42-47Z.jpg,493,CONFIG002,12,0,0.890617847442627,daisy,101,101,1379,960,1480,1061
5,0344-6782/2021-06-21/08/0344-6782_2021-06-21T08-42-47Z.jpg,493,CONFIG002,13,0,0.889378011226654,daisy,87,82,1407,651,1494,733
5,0344-6782/2021-06-21/08/0344-6782_2021-06-21T08-42-47Z.jpg,493,CONFIG002,14,0,0.8888912200927734,daisy,97,95,1225,622,1322,717
5,0344-6782/2021-06-21/08/0344-6782_2021-06-21T08-42-47Z.jpg,493,CONFIG002,15,0,0.886573851108551,daisy,80,99,962,958,1042,1057
5,0344-6782/2021-06-21/08/0344-6782_2021-06-21T08-42-47Z.jpg,493,CONFIG002,16,0,0.8703734874725342,daisy,87,85,1335,638,1422,723
5,0344-6782/2021-06-21/08/0344-6782_2021-06-21T08-42-47Z.jpg,493,CONFIG002,17,0,0.8653165102005005,daisy,73,77,1124,604,1197,681
5,0344-6782/2021-06-21/08/0344-6782_2021-06-21T08-42-47Z.jpg,493,CONFIG002,18,0,0.8562127351760864,daisy,82,91,879,836,961,927
5,0344-6782/2021-06-21/08/0344-6782_2021-06-21T08-42-47Z.jpg,493,CONFIG002,19,0,0.8503699898719788,daisy,69,65,1218,405,1287,470
5,0344-6782/2021-06-21/08/0344-6782_2021-06-21T08-42-47Z.jpg,493,CONFIG002,20,0,0.8224995732307434,daisy,75,76,1084,617,1159,693
5,0344-6782/2021-06-21/08/0344-6782_2021-06-21T08-42-47Z.jpg,493,CONFIG002,21,0,0.7929443717002869,daisy,67,64,1016,685,1083,749
5,0344-6782/2021-06-21/08/0344-6782_2021-06-21T08-42-47Z.jpg,493,CONFIG002,22,0,0.7488901019096375,daisy,85,81,1143,440,1228,521
5,0344-6782/2021-06-21/08/0344-6782_2021-06-21T08-42-47Z.jpg,493,CONFIG002,23,0,0.7168321013450623,daisy,82,76,1056,370,1138,446
5,0344-6782/2021-06-21/08/0344-6782_2021-06-21T08-42-47Z.jpg,493,CONFIG002,24,0,0.6178386211395264,daisy,63,73,1219,860,1282,933
5,0344-6782/2021-06-21/08/0344-6782_2021-06-21T08-42-47Z.jpg,493,CONFIG002,25,0,0.5463473796844482,daisy,83,72,1150,429,1233,501
6,0344-6782/2021-06-21/08/0344-6782_2021-06-21T08-36-28Z.jpg,494,CONFIG002,0,0,0.9235663414001465,daisy,84,95,1129,923,1213,1018
6,0344-6782/2021-06-21/08/0344-6782_2021-06-21T08-36-28Z.jpg,494,CONFIG002,1,0,0.9191061854362488,daisy,100,103,672,802,772,905
6,0344-6782/2021-06-21/08/0344-6782_2021-06-21T08-36-28Z.jpg,494,CONFIG002,2,0,0.9176729917526245,daisy,94,98,846,681,940,779
6,0344-6782/2021-06-21/08/0344-6782_2021-06-21T08-36-28Z.jpg,494,CONFIG002,3,0,0.9024527668952942,daisy,99,100,1379,964,1478,1064
6,0344-6782/2021-06-21/08/0344-6782_2021-06-21T08-36-28Z.jpg,494,CONFIG002,4,0,0.901874303817749,daisy,79,83,976,873,1055,956
6,0344-6782/2021-06-21/08/0344-6782_2021-06-21T08-36-28Z.jpg,494,CONFIG002,5,0,0.9017540216445923,daisy,85,101,961,960,1046,1061
6,0344-6782/2021-06-21/08/0344-6782_2021-06-21T08-36-28Z.jpg,494,CONFIG002,6,0,0.9012011289596558,daisy,78,80,856,891,934,971
6,0344-6782/2021-06-21/08/0344-6782_2021-06-21T08-36-28Z.jpg,494,CONFIG002,7,0,0.8984410762786865,daisy,86,80,1276,528,1362,608
6,0344-6782/2021-06-21/08/0344-6782_2021-06-21T08-36-28Z.jpg,494,CONFIG002,8,0,0.8977950811386108,daisy,85,74,1318,366,1403,440
6,0344-6782/2021-06-21/08/0344-6782_2021-06-21T08-36-28Z.jpg,494,CONFIG002,9,0,0.8962652683258057,daisy,79,81,1221,253,1300,334
6,0344-6782/2021-06-21/08/0344-6782_2021-06-21T08-36-28Z.jpg,494,CONFIG002,10,0,0.8951969146728516,daisy,84,79,793,615,877,694
6,0344-6782/2021-06-21/08/0344-6782_2021-06-21T08-36-28Z.jpg,494,CONFIG002,11,0,0.8936806321144104,daisy,87,84,1407,651,1494,735
6,0344-6782/2021-06-21/08/0344-6782_2021-06-21T08-36-28Z.jpg,494,CONFIG002,12,0,0.8933930993080139,daisy,94,87,1139,539,1233,626
6,0344-6782/2021-06-21/08/0344-6782_2021-06-21T08-36-28Z.jpg,494,CONFIG002,13,0,0.892266571521759,daisy,89,78,1187,348,1276,426
6,0344-6782/2021-06-21/08/0344-6782_2021-06-21T08-36-28Z.jpg,494,CONFIG002,14,0,0.8899337649345398,daisy,96,98,1241,1048,1337,1146
6,0344-6782/2021-06-21/08/0344-6782_2021-06-21T08-36-28Z.jpg,494,CONFIG002,15,0,0.8813815116882324,daisy,96,94,1226,625,1322,719
6,0344-6782/2021-06-21/08/0344-6782_2021-06-21T08-36-28Z.jpg,494,CONFIG002,16,0,0.8701493740081787,daisy,88,86,1334,636,1422,722
6,0344-6782/2021-06-21/08/0344-6782_2021-06-21T08-36-28Z.jpg,494,CONFIG002,17,0,0.8580372333526611,daisy,72,66,1218,405,1290,471
6,0344-6782/2021-06-21/08/0344-6782_2021-06-21T08-36-28Z.jpg,494,CONFIG002,18,0,0.8455721735954285,daisy,79,89,881,837,960,926
6,0344-6782/2021-06-21/08/0344-6782_2021-06-21T08-36-28Z.jpg,494,CONFIG002,19,0,0.8322305679321289,daisy,89,84,1140,434,1229,518
6,0344-6782/2021-06-21/08/0344-6782_2021-06-21T08-36-28Z.jpg,494,CONFIG002,20,0,0.8223338723182678,daisy,78,79,1082,615,1160,694
6,0344-6782/2021-06-21/08/0344-6782_2021-06-21T08-36-28Z.jpg,494,CONFIG002,21,0,0.8127054572105408,daisy,70,82,1127,604,1197,686
6,0344-6782/2021-06-21/08/0344-6782_2021-06-21T08-36-28Z.jpg,494,CONFIG002,22,0,0.7950004935264587,daisy,67,65,1016,686,1083,751
6,0344-6782/2021-06-21/08/0344-6782_2021-06-21T08-36-28Z.jpg,494,CONFIG002,23,0,0.6417306065559387,daisy,73,71,1059,379,1132,450
6,0344-6782/2021-06-21/08/0344-6782_2021-06-21T08-36-28Z.jpg,494,CONFIG002,24,0,0.5272862315177917,daisy,78,65,1083,586,1161,651
7,0344-6782/2021-06-21/08/0344-6782_2021-06-21T08-03-20Z.jpg,495,CONFIG002,0,0,0.9311888217926025,daisy,85,95,1129,929,1214,1024
7,0344-6782/2021-06-21/08/0344-6782_2021-06-21T08-03-20Z.jpg,495,CONFIG002,1,0,0.9236484169960022,daisy,102,99,1373,975,1475,1074
7,0344-6782/2021-06-21/08/0344-6782_2021-06-21T08-03-20Z.jpg,495,CONFIG002,2,0,0.9090144038200378,daisy,81,77,794,609,875,686
7,0344-6782/2021-06-21/08/0344-6782_2021-06-21T08-03-20Z.jpg,495,CONFIG002,3,0,0.9075944423675537,daisy,77,84,973,872,1050,956
7,0344-6782/2021-06-21/08/0344-6782_2021-06-21T08-03-20Z.jpg,495,CONFIG002,4,0,0.90533447265625,daisy,95,95,669,806,764,901
7,0344-6782/2021-06-21/08/0344-6782_2021-06-21T08-03-20Z.jpg,495,CONFIG002,5,0,0.904567301273346,daisy,96,99,839,676,935,775
7,0344-6782/2021-06-21/08/0344-6782_2021-06-21T08-03-20Z.jpg,495,CONFIG002,6,0,0.9008277058601379,daisy,90,85,1405,645,1495,730
7,0344-6782/2021-06-21/08/0344-6782_2021-06-21T08-03-20Z.jpg,495,CONFIG002,7,0,0.899681806564331,daisy,84,100,962,963,1046,1063
7,0344-6782/2021-06-21/08/0344-6782_2021-06-21T08-03-20Z.jpg,495,CONFIG002,8,0,0.8977538347244263,daisy,92,82,1194,339,1286,421
7,0344-6782/2021-06-21/08/0344-6782_2021-06-21T08-03-20Z.jpg,495,CONFIG002,9,0,0.89671391248703,daisy,88,80,1281,524,1369,604
7,0344-6782/2021-06-21/08/0344-6782_2021-06-21T08-03-20Z.jpg,495,CONFIG002,10,0,0.8955811858177185,daisy,97,103,1232,1051,1329,1154
7,0344-6782/2021-06-21/08/0344-6782_2021-06-21T08-03-20Z.jpg,495,CONFIG002,11,0,0.8939505219459534,daisy,80,81,853,893,933,974
7,0344-6782/2021-06-21/08/0344-6782_2021-06-21T08-03-20Z.jpg,495,CONFIG002,12,0,0.8920154571533203,daisy,99,96,1218,618,1317,714
7,0344-6782/2021-06-21/08/0344-6782_2021-06-21T08-03-20Z.jpg,495,CONFIG002,13,0,0.8784332871437073,daisy,87,74,1304,361,1391,435
7,0344-6782/2021-06-21/08/0344-6782_2021-06-21T08-03-20Z.jpg,495,CONFIG002,14,0,0.8686313033103943,daisy,86,86,1335,637,1421,723
7,0344-6782/2021-06-21/08/0344-6782_2021-06-21T08-03-20Z.jpg,495,CONFIG002,15,0,0.8673645853996277,daisy,77,81,1225,252,1302,333
7,0344-6782/2021-06-21/08/0344-6782_2021-06-21T08-03-20Z.jpg,495,CONFIG002,16,0,0.8657323122024536,daisy,95,87,1136,534,1231,621
7,0344-6782/2021-06-21/08/0344-6782_2021-06-21T08-03-20Z.jpg,495,CONFIG002,17,0,0.8630266189575195,daisy,88,79,1144,427,1232,506
7,0344-6782/2021-06-21/08/0344-6782_2021-06-21T08-03-20Z.jpg,495,CONFIG002,18,0,0.8626524806022644,daisy,75,86,881,839,956,925
7,0344-6782/2021-06-21/08/0344-6782_2021-06-21T08-03-20Z.jpg,495,CONFIG002,19,0,0.857275664806366,daisy,67,67,1226,400,1293,467
7,0344-6782/2021-06-21/08/0344-6782_2021-06-21T08-03-20Z.jpg,495,CONFIG002,20,0,0.8550100922584534,daisy,77,81,1210,850,1287,931
7,0344-6782/2021-06-21/08/0344-6782_2021-06-21T08-03-20Z.jpg,495,CONFIG002,21,0,0.8436421155929565,daisy,78,81,1082,611,1160,692
7,0344-6782/2021-06-21/08/0344-6782_2021-06-21T08-03-20Z.jpg,495,CONFIG002,22,0,0.8403980135917664,daisy,68,75,1125,604,1193,679
7,0344-6782/2021-06-21/08/0344-6782_2021-06-21T08-03-20Z.jpg,495,CONFIG002,23,0,0.819541335105896,daisy,67,66,1018,686,1085,752
7,0344-6782/2021-06-21/08/0344-6782_2021-06-21T08-03-20Z.jpg,495,CONFIG002,24,0,0.63942950963974,daisy,57,61,1001,698,1058,759
8,0344-6782/2021-06-21/08/0344-6782_2021-06-21T08-37-10Z.jpg,496,CONFIG002,0,0,0.9106523394584656,daisy,97,98,841,678,938,776
8,0344-6782/2021-06-21/08/0344-6782_2021-06-21T08-37-10Z.jpg,496,CONFIG002,1,0,0.9090534448623657,daisy,93,95,667,799,760,894
8,0344-6782/2021-06-21/08/0344-6782_2021-06-21T08-37-10Z.jpg,496,CONFIG002,2,0,0.9054604768753052,daisy,100,99,1374,965,1474,1064
8,0344-6782/2021-06-21/08/0344-6782_2021-06-21T08-37-10Z.jpg,496,CONFIG002,3,0,0.9050859808921814,daisy,82,79,790,607,872,686
8,0344-6782/2021-06-21/08/0344-6782_2021-06-21T08-37-10Z.jpg,496,CONFIG002,4,0,0.9034186601638794,daisy,80,84,976,872,1056,956
8,0344-6782/2021-06-21/08/0344-6782_2021-06-21T08-37-10Z.jpg,496,CONFIG002,5,0,0.9012129902839661,daisy,80,81,1220,251,1300,332
8,0344-6782/2021-06-21/08/0344-6782_2021-06-21T08-37-10Z.jpg,496,CONFIG002,6,0,0.9008318781852722,daisy,94,85,1135,537,1229,622
8,0344-6782/2021-06-21/08/0344-6782_2021-06-21T08-37-10Z.jpg,496,CONFIG002,7,0,0.9004813432693481,daisy,86,82,1406,652,1492,734
8,0344-6782/2021-06-21/08/0344-6782_2021-06-21T08-37-10Z.jpg,496,CONFIG002,8,0,0.8992130756378174,daisy,87,94,1124,923,1211,1017
8,0344-6782/2021-06-21/08/0344-6782_2021-06-21T08-37-10Z.jpg,496,CONFIG002,9,0,0.8973246216773987,daisy,89,80,1187,344,1276,424
8,0344-6782/2021-06-21/08/0344-6782_2021-06-21T08-37-10Z.jpg,496,CONFIG002,10,0,0.896942138671875,daisy,84,101,961,959,1045,1060
8,0344-6782/2021-06-21/08/0344-6782_2021-06-21T08-37-10Z.jpg,496,CONFIG002,11,0,0.8926553726196289,daisy,87,75,1317,365,1404,440
8,0344-6782/2021-06-21/08/0344-6782_2021-06-21T08-37-10Z.jpg,496,CONFIG002,12,0,0.8900285959243774,daisy,86,80,1275,524,1361,604
8,0344-6782/2021-06-21/08/0344-6782_2021-06-21T08-37-10Z.jpg,496,CONFIG002,13,0,0.8881466388702393,daisy,80,82,854,889,934,971
8,0344-6782/2021-06-21/08/0344-6782_2021-06-21T08-37-10Z.jpg,496,CONFIG002,14,0,0.8866543173789978,daisy,98,97,1220,618,1318,715
8,0344-6782/2021-06-21/08/0344-6782_2021-06-21T08-37-10Z.jpg,496,CONFIG002,15,0,0.8843070268630981,daisy,96,101,1239,1047,1335,1148
8,0344-6782/2021-06-21/08/0344-6782_2021-06-21T08-37-10Z.jpg,496,CONFIG002,16,0,0.8605219721794128,daisy,85,83,1328,634,1413,717
8,0344-6782/2021-06-21/08/0344-6782_2021-06-21T08-37-10Z.jpg,496,CONFIG002,17,0,0.8591947555541992,daisy,70,66,1218,405,1288,471
8,0344-6782/2021-06-21/08/0344-6782_2021-06-21T08-37-10Z.jpg,496,CONFIG002,18,0,0.8565998673439026,daisy,72,75,1122,603,1194,678
8,0344-6782/2021-06-21/08/0344-6782_2021-06-21T08-37-10Z.jpg,496,CONFIG002,19,0,0.8431428670883179,daisy,79,89,880,836,959,925
8,0344-6782/2021-06-21/08/0344-6782_2021-06-21T08-37-10Z.jpg,496,CONFIG002,20,0,0.8428897261619568,daisy,90,84,1140,434,1230,518
8,0344-6782/2021-06-21/08/0344-6782_2021-06-21T08-37-10Z.jpg,496,CONFIG002,21,0,0.8355470299720764,daisy,78,79,1081,614,1159,693
8,0344-6782/2021-06-21/08/0344-6782_2021-06-21T08-37-10Z.jpg,496,CONFIG002,22,0,0.7847474813461304,daisy,67,69,1015,681,1082,750
8,0344-6782/2021-06-21/08/0344-6782_2021-06-21T08-37-10Z.jpg,496,CONFIG002,23,0,0.5435847640037537,daisy,77,58,1083,589,1160,647
9,0344-6782/2021-06-21/08/0344-6782_2021-06-21T08-19-03Z.jpg,497,CONFIG002,0,0,0.921539843082428,daisy,100,102,1232,1047,1332,1149
9,0344-6782/2021-06-21/08/0344-6782_2021-06-21T08-19-03Z.jpg,497,CONFIG002,1,0,0.9199268817901611,daisy,98,100,838,678,936,778
9,0344-6782/2021-06-21/08/0344-6782_2021-06-21T08-19-03Z.jpg,497,CONFIG002,2,0,0.9196934103965759,daisy,95,99,667,796,762,895
9,0344-6782/2021-06-21/08/0344-6782_2021-06-21T08-19-03Z.jpg,497,CONFIG002,3,0,0.9144293069839478,daisy,96,87,1132,537,1228,624
9,0344-6782/2021-06-21/08/0344-6782_2021-06-21T08-19-03Z.jpg,497,CONFIG002,4,0,0.9109447598457336,daisy,85,92,1124,926,1209,1018
9,0344-6782/2021-06-21/08/0344-6782_2021-06-21T08-19-03Z.jpg,497,CONFIG002,5,0,0.9081590175628662,daisy,82,79,791,608,873,687
9,0344-6782/2021-06-21/08/0344-6782_2021-06-21T08-19-03Z.jpg,497,CONFIG002,6,0,0.9069174528121948,daisy,88,82,1189,341,1277,423
9,0344-6782/2021-06-21/08/0344-6782_2021-06-21T08-19-03Z.jpg,497,CONFIG002,7,0,0.9038232564926147,daisy,90,83,1404,648,1494,731
9,0344-6782/2021-06-21/08/0344-6782_2021-06-21T08-19-03Z.jpg,497,CONFIG002,8,0,0.9035091400146484,daisy,99,100,1373,967,1472,1067
9,0344-6782/2021-06-21/08/0344-6782_2021-06-21T08-19-03Z.jpg,497,CONFIG002,9,0,0.9020695686340332,daisy,80,83,1221,250,1301,333
9,0344-6782/2021-06-21/08/0344-6782_2021-06-21T08-19-03Z.jpg,497,CONFIG002,10,0,0.9005007743835449,daisy,87,101,960,960,1047,1061
9,0344-6782/2021-06-21/08/0344-6782_2021-06-21T08-19-03Z.jpg,497,CONFIG002,11,0,0.8977637887001038,daisy,81,81,852,888,933,969
9,0344-6782/2021-06-21/08/0344-6782_2021-06-21T08-19-03Z.jpg,497,CONFIG002,12,0,0.8970192670822144,daisy,86,75,1312,363,1398,438
9,0344-6782/2021-06-21/08/0344-6782_2021-06-21T08-19-03Z.jpg,497,CONFIG002,13,0,0.892874002456665,daisy,75,84,975,870,1050,954
9,0344-6782/2021-06-21/08/0344-6782_2021-06-21T08-19-03Z.jpg,497,CONFIG002,14,0,0.8920100331306458,daisy,77,87,880,837,957,924
9,0344-6782/2021-06-21/08/0344-6782_2021-06-21T08-19-03Z.jpg,497,CONFIG002,15,0,0.8908395171165466,daisy,85,79,1280,525,1365,604
9,0344-6782/2021-06-21/08/0344-6782_2021-06-21T08-19-03Z.jpg,497,CONFIG002,16,0,0.887973964214325,daisy,100,98,1219,618,1319,716
9,0344-6782/2021-06-21/08/0344-6782_2021-06-21T08-19-03Z.jpg,497,CONFIG002,17,0,0.8855498433113098,daisy,91,87,1138,429,1229,516
9,0344-6782/2021-06-21/08/0344-6782_2021-06-21T08-19-03Z.jpg,497,CONFIG002,18,0,0.8596262335777283,daisy,84,85,1333,634,1417,719
9,0344-6782/2021-06-21/08/0344-6782_2021-06-21T08-19-03Z.jpg,497,CONFIG002,19,0,0.853899359703064,daisy,77,80,1079,612,1156,692
9,0344-6782/2021-06-21/08/0344-6782_2021-06-21T08-19-03Z.jpg,497,CONFIG002,20,0,0.852671205997467,daisy,72,76,1120,602,1192,678
9,0344-6782/2021-06-21/08/0344-6782_2021-06-21T08-19-03Z.jpg,497,CONFIG002,21,0,0.8473174571990967,daisy,69,67,1220,402,1289,469
9,0344-6782/2021-06-21/08/0344-6782_2021-06-21T08-19-03Z.jpg,497,CONFIG002,22,0,0.802099347114563,daisy,70,67,1015,684,1085,751
10,0344-6782/2021-06-21/08/0344-6782_2021-06-21T08-47-53Z.jpg,498,CONFIG002,0,0,0.9175398349761963,daisy,97,100,1247,1046,1344,1146
10,0344-6782/2021-06-21/08/0344-6782_2021-06-21T08-47-53Z.jpg,498,CONFIG002,1,0,0.912038266658783,daisy,97,95,846,678,943,773
10,0344-6782/2021-06-21/08/0344-6782_2021-06-21T08-47-53Z.jpg,498,CONFIG002,2,0,0.9109705686569214,daisy,100,99,675,799,775,898
10,0344-6782/2021-06-21/08/0344-6782_2021-06-21T08-47-53Z.jpg,498,CONFIG002,3,0,0.9049428701400757,daisy,80,81,1220,252,1300,333
10,0344-6782/2021-06-21/08/0344-6782_2021-06-21T08-47-53Z.jpg,498,CONFIG002,4,0,0.9036489725112915,daisy,76,86,980,869,1056,955
10,0344-6782/2021-06-21/08/0344-6782_2021-06-21T08-47-53Z.jpg,498,CONFIG002,5,0,0.9025183320045471,daisy,100,96,1229,619,1329,715
10,0344-6782/2021-06-21/08/0344-6782_2021-06-21T08-47-53Z.jpg,498,CONFIG002,6,0,0.9015279412269592,daisy,84,89,1136,922,1220,1011
10,0344-6782/2021-06-21/08/0344-6782_2021-06-21T08-47-53Z.jpg,498,CONFIG002,7,0,0.9001816511154175,daisy,82,74,1325,368,1407,442
10,0344-6782/2021-06-21/08/0344-6782_2021-06-21T08-47-53Z.jpg,498,CONFIG002,8,0,0.8975218534469604,daisy,90,81,1188,345,1278,426
10,0344-6782/2021-06-21/08/0344-6782_2021-06-21T08-47-53Z.jpg,498,CONFIG002,9,0,0.8950063586235046,daisy,88,81,1276,526,1364,607
10,0344-6782/2021-06-21/08/0344-6782_2021-06-21T08-47-53Z.jpg,498,CONFIG002,10,0,0.8937705159187317,daisy,92,86,1141,540,1233,626
10,0344-6782/2021-06-21/08/0344-6782_2021-06-21T08-47-53Z.jpg,498,CONFIG002,11,0,0.8904723525047302,daisy,83,80,795,610,878,690
10,0344-6782/2021-06-21/08/0344-6782_2021-06-21T08-47-53Z.jpg,498,CONFIG002,12,0,0.8879449367523193,daisy,87,84,1407,651,1494,735
10,0344-6782/2021-06-21/08/0344-6782_2021-06-21T08-47-53Z.jpg,498,CONFIG002,13,0,0.8839150071144104,daisy,79,80,857,888,936,968
10,0344-6782/2021-06-21/08/0344-6782_2021-06-21T08-47-53Z.jpg,498,CONFIG002,14,0,0.8773908615112305,daisy,98,104,1386,955,1484,1059
10,0344-6782/2021-06-21/08/0344-6782_2021-06-21T08-47-53Z.jpg,498,CONFIG002,15,0,0.8755491375923157,daisy,87,86,1335,637,1422,723
10,0344-6782/2021-06-21/08/0344-6782_2021-06-21T08-47-53Z.jpg,498,CONFIG002,16,0,0.8747280836105347,daisy,83,99,963,959,1046,1058
10,0344-6782/2021-06-21/08/0344-6782_2021-06-21T08-47-53Z.jpg,498,CONFIG002,17,0,0.8698517084121704,daisy,64,70,1221,862,1285,932
10,0344-6782/2021-06-21/08/0344-6782_2021-06-21T08-47-53Z.jpg,498,CONFIG002,18,0,0.8503983616828918,daisy,72,78,1127,603,1199,681
10,0344-6782/2021-06-21/08/0344-6782_2021-06-21T08-47-53Z.jpg,498,CONFIG002,19,0,0.8503257632255554,daisy,64,61,1021,689,1085,750
10,0344-6782/2021-06-21/08/0344-6782_2021-06-21T08-47-53Z.jpg,498,CONFIG002,20,0,0.8469918966293335,daisy,72,66,1218,405,1290,471
10,0344-6782/2021-06-21/08/0344-6782_2021-06-21T08-47-53Z.jpg,498,CONFIG002,21,0,0.8382210731506348,daisy,84,89,881,836,965,925
10,0344-6782/2021-06-21/08/0344-6782_2021-06-21T08-47-53Z.jpg,498,CONFIG002,22,0,0.8152902722358704,daisy,74,77,1087,614,1161,691
10,0344-6782/2021-06-21/08/0344-6782_2021-06-21T08-47-53Z.jpg,498,CONFIG002,23,0,0.7285701036453247,daisy,84,85,1145,436,1229,521
10,0344-6782/2021-06-21/08/0344-6782_2021-06-21T08-47-53Z.jpg,498,CONFIG002,24,0,0.6966469883918762,daisy,82,75,1058,371,1140,446
11,0344-6782/2021-06-21/08/0344-6782_2021-06-21T08-33-40Z.jpg,499,CONFIG002,0,0,0.9314948916435242,daisy,85,95,1129,924,1214,1019
11,0344-6782/2021-06-21/08/0344-6782_2021-06-21T08-33-40Z.jpg,499,CONFIG002,1,0,0.9182073473930359,daisy,93,98,846,680,939,778
11,0344-6782/2021-06-21/08/0344-6782_2021-06-21T08-33-40Z.jpg,499,CONFIG002,2,0,0.9163326621055603,daisy,99,102,672,802,771,904
11,0344-6782/2021-06-21/08/0344-6782_2021-06-21T08-33-40Z.jpg,499,CONFIG002,3,0,0.9041904807090759,daisy,86,100,961,961,1047,1061
11,0344-6782/2021-06-21/08/0344-6782_2021-06-21T08-33-40Z.jpg,499,CONFIG002,4,0,0.9037708640098572,daisy,85,74,1319,366,1404,440
11,0344-6782/2021-06-21/08/0344-6782_2021-06-21T08-33-40Z.jpg,499,CONFIG002,5,0,0.9037109017372131,daisy,76,86,978,870,1054,956
11,0344-6782/2021-06-21/08/0344-6782_2021-06-21T08-33-40Z.jpg,499,CONFIG002,6,0,0.901092529296875,daisy,100,101,1379,964,1479,1065
11,0344-6782/2021-06-21/08/0344-6782_2021-06-21T08-33-40Z.jpg,499,CONFIG002,7,0,0.8997604250907898,daisy,86,79,1280,526,1366,605
11,0344-6782/2021-06-21/08/0344-6782_2021-06-21T08-33-40Z.jpg,499,CONFIG002,8,0,0.8980370759963989,daisy,79,82,1223,251,1302,333
11,0344-6782/2021-06-21/08/0344-6782_2021-06-21T08-33-40Z.jpg,499,CONFIG002,9,0,0.8966894745826721,daisy,89,81,1191,345,1280,426
11,0344-6782/2021-06-21/08/0344-6782_2021-06-21T08-33-40Z.jpg,499,CONFIG002,10,0,0.8939758539199829,daisy,93,87,1140,539,1233,626
11,0344-6782/2021-06-21/08/0344-6782_2021-06-21T08-33-40Z.jpg,499,CONFIG002,11,0,0.8912898302078247,daisy,79,81,856,890,935,971
11,0344-6782/2021-06-21/08/0344-6782_2021-06-21T08-33-40Z.jpg,499,CONFIG002,12,0,0.8896386027336121,daisy,88,82,1407,651,1495,733
11,0344-6782/2021-06-21/08/0344-6782_2021-06-21T08-33-40Z.jpg,499,CONFIG002,13,0,0.887580394744873,daisy,95,99,1243,1048,1338,1147
11,0344-6782/2021-06-21/08/0344-6782_2021-06-21T08-33-40Z.jpg,499,CONFIG002,14,0,0.8865822553634644,daisy,88,84,1335,639,1423,723
11,0344-6782/2021-06-21/08/0344-6782_2021-06-21T08-33-40Z.jpg,499,CONFIG002,15,0,0.8855950832366943,daisy,97,95,1227,623,1324,718
11,0344-6782/2021-06-21/08/0344-6782_2021-06-21T08-33-40Z.jpg,499,CONFIG002,16,0,0.8777393102645874,daisy,84,80,795,612,879,692
11,0344-6782/2021-06-21/08/0344-6782_2021-06-21T08-33-40Z.jpg,499,CONFIG002,17,0,0.8604384064674377,daisy,71,67,1218,404,1289,471
11,0344-6782/2021-06-21/08/0344-6782_2021-06-21T08-33-40Z.jpg,499,CONFIG002,18,0,0.8556067943572998,daisy,94,87,1142,430,1236,517
11,0344-6782/2021-06-21/08/0344-6782_2021-06-21T08-33-40Z.jpg,499,CONFIG002,19,0,0.8507190942764282,daisy,82,91,879,838,961,929
11,0344-6782/2021-06-21/08/0344-6782_2021-06-21T08-33-40Z.jpg,499,CONFIG002,20,0,0.8145667314529419,daisy,75,76,1085,616,1160,692
11,0344-6782/2021-06-21/08/0344-6782_2021-06-21T08-33-40Z.jpg,499,CONFIG002,21,0,0.814503014087677,daisy,69,82,1129,602,1198,684
11,0344-6782/2021-06-21/08/0344-6782_2021-06-21T08-33-40Z.jpg,499,CONFIG002,22,0,0.8037018775939941,daisy,67,64,1018,690,1085,754
11,0344-6782/2021-06-21/08/0344-6782_2021-06-21T08-33-40Z.jpg,499,CONFIG002,23,0,0.6892578601837158,daisy,57,61,1002,701,1059,762
11,0344-6782/2021-06-21/08/0344-6782_2021-06-21T08-33-40Z.jpg,499,CONFIG002,24,0,0.5648145079612732,daisy,77,66,1084,586,1161,652
12,0344-6782/2021-06-21/08/0344-6782_2021-06-21T08-12-57Z.jpg,500,CONFIG002,0,0,0.9381603598594666,daisy,94,97,674,804,768,901
12,0344-6782/2021-06-21/08/0344-6782_2021-06-21T08-12-57Z.jpg,500,CONFIG002,1,0,0.9225165247917175,daisy,100,102,1245,1044,1345,1146
12,0344-6782/2021-06-21/08/0344-6782_2021-06-21T08-12-57Z.jpg,500,CONFIG002,2,0,0.9121190905570984,daisy,95,97,845,678,940,775
12,0344-6782/2021-06-21/08/0344-6782_2021-06-21T08-12-57Z.jpg,500,CONFIG002,3,0,0.9083008170127869,daisy,76,88,978,871,1054,959
12,0344-6782/2021-06-21/08/0344-6782_2021-06-21T08-12-57Z.jpg,500,CONFIG002,4,0,0.9039268493652344,daisy,101,102,1378,964,1479,1066
12,0344-6782/2021-06-21/08/0344-6782_2021-06-21T08-12-57Z.jpg,500,CONFIG002,5,0,0.9024046659469604,daisy,85,76,1311,363,1396,439
12,0344-6782/2021-06-21/08/0344-6782_2021-06-21T08-12-57Z.jpg,500,CONFIG002,6,0,0.9010363221168518,daisy,88,82,1405,649,1493,731
12,0344-6782/2021-06-21/08/0344-6782_2021-06-21T08-12-57Z.jpg,500,CONFIG002,7,0,0.9002321362495422,daisy,79,80,857,892,936,972
12,0344-6782/2021-06-21/08/0344-6782_2021-06-21T08-12-57Z.jpg,500,CONFIG002,8,0,0.8999995589256287,daisy,89,101,962,963,1051,1064
12,0344-6782/2021-06-21/08/0344-6782_2021-06-21T08-12-57Z.jpg,500,CONFIG002,9,0,0.8988396525382996,daisy,82,91,1136,928,1218,1019
12,0344-6782/2021-06-21/08/0344-6782_2021-06-21T08-12-57Z.jpg,500,CONFIG002,10,0,0.8980759978294373,daisy,90,80,1199,345,1289,425
12,0344-6782/2021-06-21/08/0344-6782_2021-06-21T08-12-57Z.jpg,500,CONFIG002,11,0,0.8924709558486938,daisy,99,94,1230,620,1329,714
12,0344-6782/2021-06-21/08/0344-6782_2021-06-21T08-12-57Z.jpg,500,CONFIG002,12,0,0.8914135098457336,daisy,86,80,1283,526,1369,606
12,0344-6782/2021-06-21/08/0344-6782_2021-06-21T08-12-57Z.jpg,500,CONFIG002,13,0,0.891223669052124,daisy,83,78,806,609,889,687
12,0344-6782/2021-06-21/08/0344-6782_2021-06-21T08-12-57Z.jpg,500,CONFIG002,14,0,0.8893021941184998,daisy,94,86,1143,538,1237,624
12,0344-6782/2021-06-21/08/0344-6782_2021-06-21T08-12-57Z.jpg,500,CONFIG002,15,0,0.8611334562301636,daisy,85,86,1336,635,1421,721
12,0344-6782/2021-06-21/08/0344-6782_2021-06-21T08-12-57Z.jpg,500,CONFIG002,16,0,0.8571136593818665,daisy,78,83,1226,252,1304,335
12,0344-6782/2021-06-21/08/0344-6782_2021-06-21T08-12-57Z.jpg,500,CONFIG002,17,0,0.8551632165908813,daisy,69,69,1222,400,1291,469
12,0344-6782/2021-06-21/08/0344-6782_2021-06-21T08-12-57Z.jpg,500,CONFIG002,18,0,0.8526939749717712,daisy,90,82,1144,430,1234,512
12,0344-6782/2021-06-21/08/0344-6782_2021-06-21T08-12-57Z.jpg,500,CONFIG002,19,0,0.8442099094390869,daisy,83,91,882,838,965,929
12,0344-6782/2021-06-21/08/0344-6782_2021-06-21T08-12-57Z.jpg,500,CONFIG002,20,0,0.8116872310638428,daisy,68,80,1131,605,1199,685
12,0344-6782/2021-06-21/08/0344-6782_2021-06-21T08-12-57Z.jpg,500,CONFIG002,21,0,0.8113936185836792,daisy,74,75,1087,614,1161,689
12,0344-6782/2021-06-21/08/0344-6782_2021-06-21T08-12-57Z.jpg,500,CONFIG002,22,0,0.797625720500946,daisy,68,66,1018,687,1086,753
12,0344-6782/2021-06-21/08/0344-6782_2021-06-21T08-12-57Z.jpg,500,CONFIG002,23,0,0.7631467580795288,daisy,57,63,1003,698,1060,761
12,0344-6782/2021-06-21/08/0344-6782_2021-06-21T08-12-57Z.jpg,500,CONFIG002,24,0,0.6552273631095886,daisy,79,58,1088,588,1167,646
13,0344-6782/2021-06-21/08/0344-6782_2021-06-21T08-37-22Z.jpg,501,CONFIG002,0,0,0.9184942841529846,daisy,96,98,843,679,939,777
13,0344-6782/2021-06-21/08/0344-6782_2021-06-21T08-37-22Z.jpg,501,CONFIG002,1,0,0.9133458137512207,daisy,86,95,1127,923,1213,1018
13,0344-6782/2021-06-21/08/0344-6782_2021-06-21T08-37-22Z.jpg,501,CONFIG002,2,0,0.9098053574562073,daisy,82,78,794,610,876,688
13,0344-6782/2021-06-21/08/0344-6782_2021-06-21T08-37-22Z.jpg,501,CONFIG002,3,0,0.9033535718917847,daisy,98,102,672,799,770,901
13,0344-6782/2021-06-21/08/0344-6782_2021-06-21T08-37-22Z.jpg,501,CONFIG002,4,0,0.9022092819213867,daisy,98,100,1379,964,1477,1064
13,0344-6782/2021-06-21/08/0344-6782_2021-06-21T08-37-22Z.jpg,501,CONFIG002,5,0,0.90179044008255,daisy,77,84,977,871,1054,955
13,0344-6782/2021-06-21/08/0344-6782_2021-06-21T08-37-22Z.jpg,501,CONFIG002,6,0,0.9016216397285461,daisy,79,81,1221,252,1300,333
13,0344-6782/2021-06-21/08/0344-6782_2021-06-21T08-37-22Z.jpg,501,CONFIG002,7,0,0.9009004831314087,daisy,89,81,1188,344,1277,425
13,0344-6782/2021-06-21/08/0344-6782_2021-06-21T08-37-22Z.jpg,501,CONFIG002,8,0,0.9007222652435303,daisy,94,87,1137,539,1231,626
13,0344-6782/2021-06-21/08/0344-6782_2021-06-21T08-37-22Z.jpg,501,CONFIG002,9,0,0.9004554152488708,daisy,82,73,1323,367,1405,440
13,0344-6782/2021-06-21/08/0344-6782_2021-06-21T08-37-22Z.jpg,501,CONFIG002,10,0,0.9001982808113098,daisy,84,100,962,960,1046,1060
13,0344-6782/2021-06-21/08/0344-6782_2021-06-21T08-37-22Z.jpg,501,CONFIG002,11,0,0.8978111147880554,daisy,88,81,1277,526,1365,607
13,0344-6782/2021-06-21/08/0344-6782_2021-06-21T08-37-22Z.jpg,501,CONFIG002,12,0,0.8928704857826233,daisy,79,81,855,889,934,970
13,0344-6782/2021-06-21/08/0344-6782_2021-06-21T08-37-22Z.jpg,501,CONFIG002,13,0,0.8924450874328613,daisy,96,99,1241,1047,1337,1146
13,0344-6782/2021-06-21/08/0344-6782_2021-06-21T08-37-22Z.jpg,501,CONFIG002,14,0,0.8902876973152161,daisy,86,83,1407,651,1493,734
13,0344-6782/2021-06-21/08/0344-6782_2021-06-21T08-37-22Z.jpg,501,CONFIG002,15,0,0.8867637515068054,daisy,87,85,1333,638,1420,723
13,0344-6782/2021-06-21/08/0344-6782_2021-06-21T08-37-22Z.jpg,501,CONFIG002,16,0,0.8830678462982178,daisy,96,94,1226,624,1322,718
13,0344-6782/2021-06-21/08/0344-6782_2021-06-21T08-37-22Z.jpg,501,CONFIG002,17,0,0.8623471260070801,daisy,70,66,1218,405,1288,471
13,0344-6782/2021-06-21/08/0344-6782_2021-06-21T08-37-22Z.jpg,501,CONFIG002,18,0,0.8434637784957886,daisy,80,89,879,837,959,926
13,0344-6782/2021-06-21/08/0344-6782_2021-06-21T08-37-22Z.jpg,501,CONFIG002,19,0,0.8263959288597107,daisy,76,77,1083,616,1159,693
13,0344-6782/2021-06-21/08/0344-6782_2021-06-21T08-37-22Z.jpg,501,CONFIG002,20,0,0.8251762390136719,daisy,89,84,1142,435,1231,519
13,0344-6782/2021-06-21/08/0344-6782_2021-06-21T08-37-22Z.jpg,501,CONFIG002,21,0,0.8057289719581604,daisy,72,77,1125,606,1197,683
13,0344-6782/2021-06-21/08/0344-6782_2021-06-21T08-37-22Z.jpg,501,CONFIG002,22,0,0.7789566516876221,daisy,68,66,1016,685,1084,751
14,0344-6782/2021-06-21/08/0344-6782_2021-06-21T08-04-51Z.jpg,502,CONFIG002,0,0,0.9296908378601074,daisy,85,94,1129,930,1214,1024
14,0344-6782/2021-06-21/08/0344-6782_2021-06-21T08-04-51Z.jpg,502,CONFIG002,1,0,0.922687292098999,daisy,101,99,1373,976,1474,1075
14,0344-6782/2021-06-21/08/0344-6782_2021-06-21T08-04-51Z.jpg,502,CONFIG002,2,0,0.9099226593971252,daisy,81,77,794,610,875,687
14,0344-6782/2021-06-21/08/0344-6782_2021-06-21T08-04-51Z.jpg,502,CONFIG002,3,0,0.9078762531280518,daisy,97,99,839,676,936,775
14,0344-6782/2021-06-21/08/0344-6782_2021-06-21T08-04-51Z.jpg,502,CONFIG002,4,0,0.9074382781982422,daisy,76,85,974,872,1050,957
14,0344-6782/2021-06-21/08/0344-6782_2021-06-21T08-04-51Z.jpg,502,CONFIG002,5,0,0.9026861190795898,daisy,86,100,961,964,1047,1064
14,0344-6782/2021-06-21/08/0344-6782_2021-06-21T08-04-51Z.jpg,502,CONFIG002,6,0,0.9018585085868835,daisy,95,96,669,806,764,902
14,0344-6782/2021-06-21/08/0344-6782_2021-06-21T08-04-51Z.jpg,502,CONFIG002,7,0,0.8975674510002136,daisy,91,85,1405,646,1496,731
14,0344-6782/2021-06-21/08/0344-6782_2021-06-21T08-04-51Z.jpg,502,CONFIG002,8,0,0.8961994051933289,daisy,79,80,854,894,933,974
14,0344-6782/2021-06-21/08/0344-6782_2021-06-21T08-04-51Z.jpg,502,CONFIG002,9,0,0.8953033685684204,daisy,90,81,1197,342,1287,423
14,0344-6782/2021-06-21/08/0344-6782_2021-06-21T08-04-51Z.jpg,502,CONFIG002,10,0,0.8949281573295593,daisy,94,103,1233,1049,1327,1152
14,0344-6782/2021-06-21/08/0344-6782_2021-06-21T08-04-51Z.jpg,502,CONFIG002,11,0,0.8923494219779968,daisy,89,80,1281,525,1370,605
14,0344-6782/2021-06-21/08/0344-6782_2021-06-21T08-04-51Z.jpg,502,CONFIG002,12,0,0.8917630314826965,daisy,99,98,1219,618,1318,716
14,0344-6782/2021-06-21/08/0344-6782_2021-06-21T08-04-51Z.jpg,502,CONFIG002,13,0,0.8882142305374146,daisy,87,84,1335,639,1422,723
14,0344-6782/2021-06-21/08/0344-6782_2021-06-21T08-04-51Z.jpg,502,CONFIG002,14,0,0.8778195381164551,daisy,94,87,1139,536,1233,623
14,0344-6782/2021-06-21/08/0344-6782_2021-06-21T08-04-51Z.jpg,502,CONFIG002,15,0,0.8671223521232605,daisy,67,68,1227,400,1294,468
14,0344-6782/2021-06-21/08/0344-6782_2021-06-21T08-04-51Z.jpg,502,CONFIG002,16,0,0.8629752993583679,daisy,73,88,882,839,955,927
14,0344-6782/2021-06-21/08/0344-6782_2021-06-21T08-04-51Z.jpg,502,CONFIG002,17,0,0.8628363013267517,daisy,90,81,1145,427,1235,508
14,0344-6782/2021-06-21/08/0344-6782_2021-06-21T08-04-51Z.jpg,502,CONFIG002,18,0,0.8576639890670776,daisy,85,72,1306,363,1391,435
14,0344-6782/2021-06-21/08/0344-6782_2021-06-21T08-04-51Z.jpg,502,CONFIG002,19,0,0.8559778928756714,daisy,78,82,1226,251,1304,333
14,0344-6782/2021-06-21/08/0344-6782_2021-06-21T08-04-51Z.jpg,502,CONFIG002,20,0,0.8333083391189575,daisy,80,82,1081,611,1161,693
14,0344-6782/2021-06-21/08/0344-6782_2021-06-21T08-04-51Z.jpg,502,CONFIG002,21,0,0.8263036608695984,daisy,70,76,1124,604,1194,680
14,0344-6782/2021-06-21/08/0344-6782_2021-06-21T08-04-51Z.jpg,502,CONFIG002,22,0,0.8180790543556213,daisy,75,80,1212,852,1287,932
14,0344-6782/2021-06-21/08/0344-6782_2021-06-21T08-04-51Z.jpg,502,CONFIG002,23,0,0.8171865344047546,daisy,67,67,1018,685,1085,752
14,0344-6782/2021-06-21/08/0344-6782_2021-06-21T08-04-51Z.jpg,502,CONFIG002,24,0,0.7411240339279175,daisy,57,61,1000,699,1057,760
15,0344-6782/2021-06-21/08/0344-6782_2021-06-21T08-27-28Z.jpg,503,CONFIG002,0,0,0.9251933693885803,daisy,99,98,671,799,770,897
15,0344-6782/2021-06-21/08/0344-6782_2021-06-21T08-27-28Z.jpg,503,CONFIG002,1,0,0.9190734028816223,daisy,96,98,844,678,940,776
15,0344-6782/2021-06-21/08/0344-6782_2021-06-21T08-27-28Z.jpg,503,CONFIG002,2,0,0.9114235639572144,daisy,84,93,1131,923,1215,1016
15,0344-6782/2021-06-21/08/0344-6782_2021-06-21T08-27-28Z.jpg,503,CONFIG002,3,0,0.9037692546844482,daisy,87,101,961,960,1048,1061
15,0344-6782/2021-06-21/08/0344-6782_2021-06-21T08-27-28Z.jpg,503,CONFIG002,4,0,0.9029380679130554,daisy,88,80,1407,650,1495,730
15,0344-6782/2021-06-21/08/0344-6782_2021-06-21T08-27-28Z.jpg,503,CONFIG002,5,0,0.8996623158454895,daisy,96,98,1241,1048,1337,1146
15,0344-6782/2021-06-21/08/0344-6782_2021-06-21T08-27-28Z.jpg,503,CONFIG002,6,0,0.8984575271606445,daisy,80,77,797,609,877,686
15,0344-6782/2021-06-21/08/0344-6782_2021-06-21T08-27-28Z.jpg,503,CONFIG002,7,0,0.8956117033958435,daisy,88,81,1191,342,1279,423
15,0344-6782/2021-06-21/08/0344-6782_2021-06-21T08-27-28Z.jpg,503,CONFIG002,8,0,0.8955020904541016,daisy,78,84,978,870,1056,954
15,0344-6782/2021-06-21/08/0344-6782_2021-06-21T08-27-28Z.jpg,503,CONFIG002,9,0,0.8943831920623779,daisy,86,75,1317,364,1403,439
15,0344-6782/2021-06-21/08/0344-6782_2021-06-21T08-27-28Z.jpg,503,CONFIG002,10,0,0.8938125371932983,daisy,79,82,1223,251,1302,333
15,0344-6782/2021-06-21/08/0344-6782_2021-06-21T08-27-28Z.jpg,503,CONFIG002,11,0,0.893458366394043,daisy,97,103,1381,961,1478,1064
15,0344-6782/2021-06-21/08/0344-6782_2021-06-21T08-27-28Z.jpg,503,CONFIG002,12,0,0.893104076385498,daisy,85,79,1280,525,1365,604
15,0344-6782/2021-06-21/08/0344-6782_2021-06-21T08-27-28Z.jpg,503,CONFIG002,13,0,0.8881641626358032,daisy,79,81,856,889,935,970
15,0344-6782/2021-06-21/08/0344-6782_2021-06-21T08-27-28Z.jpg,503,CONFIG002,14,0,0.8856381177902222,daisy,94,86,1140,536,1234,622
15,0344-6782/2021-06-21/08/0344-6782_2021-06-21T08-27-28Z.jpg,503,CONFIG002,15,0,0.8833283185958862,daisy,97,96,1225,621,1322,717
15,0344-6782/2021-06-21/08/0344-6782_2021-06-21T08-27-28Z.jpg,503,CONFIG002,16,0,0.8748550415039062,daisy,85,85,1336,637,1421,722
15,0344-6782/2021-06-21/08/0344-6782_2021-06-21T08-27-28Z.jpg,503,CONFIG002,17,0,0.8677117824554443,daisy,72,77,1126,603,1198,680
15,0344-6782/2021-06-21/08/0344-6782_2021-06-21T08-27-28Z.jpg,503,CONFIG002,18,0,0.8642258048057556,daisy,93,88,1139,430,1232,518
15,0344-6782/2021-06-21/08/0344-6782_2021-06-21T08-27-28Z.jpg,503,CONFIG002,19,0,0.8620136380195618,daisy,65,61,1020,690,1085,751
15,0344-6782/2021-06-21/08/0344-6782_2021-06-21T08-27-28Z.jpg,503,CONFIG002,20,0,0.857864260673523,daisy,70,66,1219,403,1289,469
15,0344-6782/2021-06-21/08/0344-6782_2021-06-21T08-27-28Z.jpg,503,CONFIG002,21,0,0.832741379737854,daisy,83,91,879,836,962,927
15,0344-6782/2021-06-21/08/0344-6782_2021-06-21T08-27-28Z.jpg,503,CONFIG002,22,0,0.8310974836349487,daisy,75,76,1084,614,1159,690
16,0344-6782/2021-06-21/08/0344-6782_2021-06-21T08-57-29Z.jpg,504,CONFIG002,0,0,0.9187430143356323,daisy,87,81,1272,524,1359,605
16,0344-6782/2021-06-21/08/0344-6782_2021-06-21T08-57-29Z.jpg,504,CONFIG002,1,0,0.9088541269302368,daisy,95,97,845,678,940,775
16,0344-6782/2021-06-21/08/0344-6782_2021-06-21T08-57-29Z.jpg,504,CONFIG002,2,0,0.9075265526771545,daisy,79,81,1220,252,1299,333
16,0344-6782/2021-06-21/08/0344-6782_2021-06-21T08-57-29Z.jpg,504,CONFIG002,3,0,0.9074567556381226,daisy,99,100,1244,1046,1343,1146
16,0344-6782/2021-06-21/08/0344-6782_2021-06-21T08-57-29Z.jpg,504,CONFIG002,4,0,0.9072149991989136,daisy,83,89,1136,922,1219,1011
16,0344-6782/2021-06-21/08/0344-6782_2021-06-21T08-57-29Z.jpg,504,CONFIG002,5,0,0.9068405628204346,daisy,100,98,1226,616,1326,714
16,0344-6782/2021-06-21/08/0344-6782_2021-06-21T08-57-29Z.jpg,504,CONFIG002,6,0,0.8995271921157837,daisy,78,86,978,868,1056,954
16,0344-6782/2021-06-21/08/0344-6782_2021-06-21T08-57-29Z.jpg,504,CONFIG002,7,0,0.8987144231796265,daisy,87,85,1406,652,1493,737
16,0344-6782/2021-06-21/08/0344-6782_2021-06-21T08-57-29Z.jpg,504,CONFIG002,8,0,0.8959387540817261,daisy,90,79,1185,347,1275,426
16,0344-6782/2021-06-21/08/0344-6782_2021-06-21T08-57-29Z.jpg,504,CONFIG002,9,0,0.895928680896759,daisy,98,92,671,796,769,888
16,0344-6782/2021-06-21/08/0344-6782_2021-06-21T08-57-29Z.jpg,504,CONFIG002,10,0,0.8918835520744324,daisy,82,74,1326,369,1408,443
16,0344-6782/2021-06-21/08/0344-6782_2021-06-21T08-57-29Z.jpg,504,CONFIG002,11,0,0.8918282389640808,daisy,95,86,1137,538,1232,624
16,0344-6782/2021-06-21/08/0344-6782_2021-06-21T08-57-29Z.jpg,504,CONFIG002,12,0,0.8881939053535461,daisy,79,80,855,887,934,967
16,0344-6782/2021-06-21/08/0344-6782_2021-06-21T08-57-29Z.jpg,504,CONFIG002,13,0,0.8867504000663757,daisy,78,77,797,600,875,677
16,0344-6782/2021-06-21/08/0344-6782_2021-06-21T08-57-29Z.jpg,504,CONFIG002,14,0,0.8860384225845337,daisy,82,98,964,958,1046,1056
16,0344-6782/2021-06-21/08/0344-6782_2021-06-21T08-57-29Z.jpg,504,CONFIG002,15,0,0.8857561945915222,daisy,100,104,1383,953,1483,1057
16,0344-6782/2021-06-21/08/0344-6782_2021-06-21T08-57-29Z.jpg,504,CONFIG002,16,0,0.8626596331596375,daisy,84,89,879,836,963,925
16,0344-6782/2021-06-21/08/0344-6782_2021-06-21T08-57-29Z.jpg,504,CONFIG002,17,0,0.8519521951675415,daisy,85,85,1332,634,1417,719
16,0344-6782/2021-06-21/08/0344-6782_2021-06-21T08-57-29Z.jpg,504,CONFIG002,18,0,0.8498421311378479,daisy,75,77,1122,602,1197,679
16,0344-6782/2021-06-21/08/0344-6782_2021-06-21T08-57-29Z.jpg,504,CONFIG002,19,0,0.8451906442642212,daisy,63,62,1021,686,1084,748
16,0344-6782/2021-06-21/08/0344-6782_2021-06-21T08-57-29Z.jpg,504,CONFIG002,20,0,0.8383110761642456,daisy,70,65,1220,407,1290,472
16,0344-6782/2021-06-21/08/0344-6782_2021-06-21T08-57-29Z.jpg,504,CONFIG002,21,0,0.8270066380500793,daisy,77,78,1083,615,1160,693
16,0344-6782/2021-06-21/08/0344-6782_2021-06-21T08-57-29Z.jpg,504,CONFIG002,22,0,0.6943633556365967,daisy,76,69,1157,428,1233,497
16,0344-6782/2021-06-21/08/0344-6782_2021-06-21T08-57-29Z.jpg,504,CONFIG002,23,0,0.6804520487785339,daisy,84,87,1146,435,1230,522
16,0344-6782/2021-06-21/08/0344-6782_2021-06-21T08-57-29Z.jpg,504,CONFIG002,24,0,0.6671223044395447,daisy,82,73,1058,372,1140,445
16,0344-6782/2021-06-21/08/0344-6782_2021-06-21T08-57-29Z.jpg,504,CONFIG002,25,0,0.5650557279586792,daisy,77,57,1084,590,1161,647
16,0344-6782/2021-06-21/08/0344-6782_2021-06-21T08-57-29Z.jpg,504,CONFIG002,26,0,0.5333667993545532,daisy,64,74,1219,859,1283,933
17,0344-6782/2021-06-21/08/0344-6782_2021-06-21T08-48-59Z.jpg,505,CONFIG002,0,0,0.9161416888237,daisy,95,98,843,679,938,777
17,0344-6782/2021-06-21/08/0344-6782_2021-06-21T08-48-59Z.jpg,505,CONFIG002,1,0,0.9075530767440796,daisy,92,86,1136,539,1228,625
17,0344-6782/2021-06-21/08/0344-6782_2021-06-21T08-48-59Z.jpg,505,CONFIG002,2,0,0.9064325094223022,daisy,81,78,794,609,875,687
17,0344-6782/2021-06-21/08/0344-6782_2021-06-21T08-48-59Z.jpg,505,CONFIG002,3,0,0.905144214630127,daisy,87,84,1406,651,1493,735
17,0344-6782/2021-06-21/08/0344-6782_2021-06-21T08-48-59Z.jpg,505,CONFIG002,4,0,0.901411235332489,daisy,96,97,1242,1049,1338,1146
17,0344-6782/2021-06-21/08/0344-6782_2021-06-21T08-48-59Z.jpg,505,CONFIG002,5,0,0.8995651602745056,daisy,81,80,854,887,935,967
17,0344-6782/2021-06-21/08/0344-6782_2021-06-21T08-48-59Z.jpg,505,CONFIG002,6,0,0.899411141872406,daisy,82,74,1325,368,1407,442
17,0344-6782/2021-06-21/08/0344-6782_2021-06-21T08-48-59Z.jpg,505,CONFIG002,7,0,0.8988378643989563,daisy,80,81,1218,251,1298,332
17,0344-6782/2021-06-21/08/0344-6782_2021-06-21T08-48-59Z.jpg,505,CONFIG002,8,0,0.8979599475860596,daisy,90,81,1182,343,1272,424
17,0344-6782/2021-06-21/08/0344-6782_2021-06-21T08-48-59Z.jpg,505,CONFIG002,9,0,0.8950374126434326,daisy,86,81,1275,526,1361,607
17,0344-6782/2021-06-21/08/0344-6782_2021-06-21T08-48-59Z.jpg,505,CONFIG002,10,0,0.8949776291847229,daisy,96,93,671,799,767,892
17,0344-6782/2021-06-21/08/0344-6782_2021-06-21T08-48-59Z.jpg,505,CONFIG002,11,0,0.8912844657897949,daisy,80,84,976,869,1056,953
17,0344-6782/2021-06-21/08/0344-6782_2021-06-21T08-48-59Z.jpg,505,CONFIG002,12,0,0.8907386660575867,daisy,98,97,1223,620,1321,717
17,0344-6782/2021-06-21/08/0344-6782_2021-06-21T08-48-59Z.jpg,505,CONFIG002,13,0,0.8862323760986328,daisy,99,101,1380,960,1479,1061
17,0344-6782/2021-06-21/08/0344-6782_2021-06-21T08-48-59Z.jpg,505,CONFIG002,14,0,0.8835157155990601,daisy,86,92,1129,921,1215,1013
17,0344-6782/2021-06-21/08/0344-6782_2021-06-21T08-48-59Z.jpg,505,CONFIG002,15,0,0.8825243711471558,daisy,79,90,882,834,961,924
17,0344-6782/2021-06-21/08/0344-6782_2021-06-21T08-48-59Z.jpg,505,CONFIG002,16,0,0.8804818391799927,daisy,81,100,962,957,1043,1057
17,0344-6782/2021-06-21/08/0344-6782_2021-06-21T08-48-59Z.jpg,505,CONFIG002,17,0,0.8720689415931702,daisy,74,76,1121,603,1195,679
17,0344-6782/2021-06-21/08/0344-6782_2021-06-21T08-48-59Z.jpg,505,CONFIG002,18,0,0.851572573184967,daisy,85,84,1332,635,1417,719
17,0344-6782/2021-06-21/08/0344-6782_2021-06-21T08-48-59Z.jpg,505,CONFIG002,19,0,0.8421839475631714,daisy,77,78,1081,615,1158,693
17,0344-6782/2021-06-21/08/0344-6782_2021-06-21T08-48-59Z.jpg,505,CONFIG002,20,0,0.8404986262321472,daisy,69,65,1218,405,1287,470
17,0344-6782/2021-06-21/08/0344-6782_2021-06-21T08-48-59Z.jpg,505,CONFIG002,21,0,0.8056288361549377,daisy,66,72,1215,859,1281,931
17,0344-6782/2021-06-21/08/0344-6782_2021-06-21T08-48-59Z.jpg,505,CONFIG002,22,0,0.7971950173377991,daisy,80,76,1057,370,1137,446
17,0344-6782/2021-06-21/08/0344-6782_2021-06-21T08-48-59Z.jpg,505,CONFIG002,23,0,0.7900505065917969,daisy,69,69,1012,680,1081,749
17,0344-6782/2021-06-21/08/0344-6782_2021-06-21T08-48-59Z.jpg,505,CONFIG002,24,0,0.6944632530212402,daisy,90,88,1143,432,1233,520
17,0344-6782/2021-06-21/08/0344-6782_2021-06-21T08-48-59Z.jpg,505,CONFIG002,25,0,0.5519739389419556,daisy,82,84,1097,604,1179,688
18,0344-6782/2021-06-21/08/0344-6782_2021-06-21T08-20-57Z.jpg,506,CONFIG002,0,0,0.9331174492835999,daisy,99,98,668,801,767,899
18,0344-6782/2021-06-21/08/0344-6782_2021-06-21T08-20-57Z.jpg,506,CONFIG002,1,0,0.9195320010185242,daisy,99,102,838,676,937,778
18,0344-6782/2021-06-21/08/0344-6782_2021-06-21T08-20-57Z.jpg,506,CONFIG002,2,0,0.9156506657600403,daisy,83,79,792,609,875,688
18,0344-6782/2021-06-21/08/0344-6782_2021-06-21T08-20-57Z.jpg,506,CONFIG002,3,0,0.9130651354789734,daisy,84,92,1126,927,1210,1019
18,0344-6782/2021-06-21/08/0344-6782_2021-06-21T08-20-57Z.jpg,506,CONFIG002,4,0,0.9110230207443237,daisy,93,86,1135,538,1228,624
18,0344-6782/2021-06-21/08/0344-6782_2021-06-21T08-20-57Z.jpg,506,CONFIG002,5,0,0.9093576073646545,daisy,98,102,1234,1048,1332,1150
18,0344-6782/2021-06-21/08/0344-6782_2021-06-21T08-20-57Z.jpg,506,CONFIG002,6,0,0.9029367566108704,daisy,85,76,1313,363,1398,439
18,0344-6782/2021-06-21/08/0344-6782_2021-06-21T08-20-57Z.jpg,506,CONFIG002,7,0,0.9012528657913208,daisy,87,82,1405,649,1492,731
18,0344-6782/2021-06-21/08/0344-6782_2021-06-21T08-20-57Z.jpg,506,CONFIG002,8,0,0.9009565711021423,daisy,89,81,1188,343,1277,424
18,0344-6782/2021-06-21/08/0344-6782_2021-06-21T08-20-57Z.jpg,506,CONFIG002,9,0,0.899813711643219,daisy,97,100,1374,967,1471,1067
18,0344-6782/2021-06-21/08/0344-6782_2021-06-21T08-20-57Z.jpg,506,CONFIG002,10,0,0.8983371257781982,daisy,79,82,1220,251,1299,333
18,0344-6782/2021-06-21/08/0344-6782_2021-06-21T08-20-57Z.jpg,506,CONFIG002,11,0,0.8979673981666565,daisy,82,99,960,960,1042,1059
18,0344-6782/2021-06-21/08/0344-6782_2021-06-21T08-20-57Z.jpg,506,CONFIG002,12,0,0.8966438174247742,daisy,76,83,974,870,1050,953
18,0344-6782/2021-06-21/08/0344-6782_2021-06-21T08-20-57Z.jpg,506,CONFIG002,13,0,0.8962064385414124,daisy,99,97,1222,620,1321,717
18,0344-6782/2021-06-21/08/0344-6782_2021-06-21T08-20-57Z.jpg,506,CONFIG002,14,0,0.8943705558776855,daisy,78,88,880,836,958,924
18,0344-6782/2021-06-21/08/0344-6782_2021-06-21T08-20-57Z.jpg,506,CONFIG002,15,0,0.8920276165008545,daisy,81,80,852,890,933,970
18,0344-6782/2021-06-21/08/0344-6782_2021-06-21T08-20-57Z.jpg,506,CONFIG002,16,0,0.8874305486679077,daisy,84,80,1279,525,1363,605
18,0344-6782/2021-06-21/08/0344-6782_2021-06-21T08-20-57Z.jpg,506,CONFIG002,17,0,0.8872993588447571,daisy,94,86,1137,430,1231,516
18,0344-6782/2021-06-21/08/0344-6782_2021-06-21T08-20-57Z.jpg,506,CONFIG002,18,0,0.8656662106513977,daisy,74,77,1121,604,1195,681
18,0344-6782/2021-06-21/08/0344-6782_2021-06-21T08-20-57Z.jpg,506,CONFIG002,19,0,0.8583652973175049,daisy,85,84,1332,636,1417,720
18,0344-6782/2021-06-21/08/0344-6782_2021-06-21T08-20-57Z.jpg,506,CONFIG002,20,0,0.8466587066650391,daisy,78,78,1079,615,1157,693
18,0344-6782/2021-06-21/08/0344-6782_2021-06-21T08-20-57Z.jpg,506,CONFIG002,21,0,0.8422643542289734,daisy,69,67,1218,402,1287,469
18,0344-6782/2021-06-21/08/0344-6782_2021-06-21T08-20-57Z.jpg,506,CONFIG002,22,0,0.7757468819618225,daisy,70,72,1012,679,1082,751
18,0344-6782/2021-06-21/08/0344-6782_2021-06-21T08-20-57Z.jpg,506,CONFIG002,23,0,0.5955743193626404,daisy,78,58,1082,589,1160,647
19,0344-6782/2021-06-21/08/0344-6782_2021-06-21T08-58-23Z.jpg,507,CONFIG002,0,0,0.9203904867172241,daisy,87,81,1272,524,1359,605
19,0344-6782/2021-06-21/08/0344-6782_2021-06-21T08-58-23Z.jpg,507,CONFIG002,1,0,0.9110313653945923,daisy,100,103,1244,1044,1344,1147
19,0344-6782/2021-06-21/08/0344-6782_2021-06-21T08-58-23Z.jpg,507,CONFIG002,2,0,0.9043247103691101,daisy,79,86,886,831,965,917
19,0344-6782/2021-06-21/08/0344-6782_2021-06-21T08-58-23Z.jpg,507,CONFIG002,3,0,0.9038660526275635,daisy,99,97,846,676,945,773
19,0344-6782/2021-06-21/08/0344-6782_2021-06-21T08-58-23Z.jpg,507,CONFIG002,4,0,0.9022947549819946,daisy,77,86,979,867,1056,953
19,0344-6782/2021-06-21/08/0344-6782_2021-06-21T08-58-23Z.jpg,507,CONFIG002,5,0,0.9009664058685303,daisy,79,80,1221,253,1300,333
19,0344-6782/2021-06-21/08/0344-6782_2021-06-21T08-58-23Z.jpg,507,CONFIG002,6,0,0.8989176154136658,daisy,99,98,1226,617,1325,715
19,0344-6782/2021-06-21/08/0344-6782_2021-06-21T08-58-23Z.jpg,507,CONFIG002,7,0,0.8980274200439453,daisy,93,86,1137,539,1230,625
19,0344-6782/2021-06-21/08/0344-6782_2021-06-21T08-58-23Z.jpg,507,CONFIG002,8,0,0.893714189529419,daisy,89,79,1188,347,1277,426
19,0344-6782/2021-06-21/08/0344-6782_2021-06-21T08-58-23Z.jpg,507,CONFIG002,9,0,0.8927139639854431,daisy,86,83,1407,652,1493,735
19,0344-6782/2021-06-21/08/0344-6782_2021-06-21T08-58-23Z.jpg,507,CONFIG002,10,0,0.8910830616950989,daisy,84,99,965,956,1049,1055
19,0344-6782/2021-06-21/08/0344-6782_2021-06-21T08-58-23Z.jpg,507,CONFIG002,11,0,0.8908496499061584,daisy,83,76,1325,369,1408,445
19,0344-6782/2021-06-21/08/0344-6782_2021-06-21T08-58-23Z.jpg,507,CONFIG002,12,0,0.885204553604126,daisy,80,77,798,589,878,666
19,0344-6782/2021-06-21/08/0344-6782_2021-06-21T08-58-23Z.jpg,507,CONFIG002,13,0,0.8785703778266907,daisy,97,104,1386,953,1483,1057
19,0344-6782/2021-06-21/08/0344-6782_2021-06-21T08-58-23Z.jpg,507,CONFIG002,14,0,0.877436101436615,daisy,92,90,670,782,762,872
19,0344-6782/2021-06-21/08/0344-6782_2021-06-21T08-58-23Z.jpg,507,CONFIG002,15,0,0.8751442432403564,daisy,81,90,1141,920,1222,1010
19,0344-6782/2021-06-21/08/0344-6782_2021-06-21T08-58-23Z.jpg,507,CONFIG002,16,0,0.869640052318573,daisy,81,79,858,884,939,963
19,0344-6782/2021-06-21/08/0344-6782_2021-06-21T08-58-23Z.jpg,507,CONFIG002,17,0,0.8589717745780945,daisy,85,83,1330,634,1415,717
19,0344-6782/2021-06-21/08/0344-6782_2021-06-21T08-58-23Z.jpg,507,CONFIG002,18,0,0.8488950133323669,daisy,64,62,1021,688,1085,750
19,0344-6782/2021-06-21/08/0344-6782_2021-06-21T08-58-23Z.jpg,507,CONFIG002,19,0,0.8458800315856934,daisy,73,67,1218,406,1291,473
19,0344-6782/2021-06-21/08/0344-6782_2021-06-21T08-58-23Z.jpg,507,CONFIG002,20,0,0.8368731737136841,daisy,72,77,1125,603,1197,680
19,0344-6782/2021-06-21/08/0344-6782_2021-06-21T08-58-23Z.jpg,507,CONFIG002,21,0,0.7816572785377502,daisy,77,80,1087,613,1164,693
19,0344-6782/2021-06-21/08/0344-6782_2021-06-21T08-58-23Z.jpg,507,CONFIG002,22,0,0.7068384289741516,daisy,84,87,1148,435,1232,522
19,0344-6782/2021-06-21/08/0344-6782_2021-06-21T08-58-23Z.jpg,507,CONFIG002,23,0,0.6073586940765381,daisy,82,73,1059,374,1141,447
19,0344-6782/2021-06-21/08/0344-6782_2021-06-21T08-58-23Z.jpg,507,CONFIG002,24,0,0.588537335395813,daisy,63,75,1221,858,1284,933
20,0344-6782/2021-06-21/08/0344-6782_2021-06-21T08-20-09Z.jpg,508,CONFIG002,0,0,0.9324498176574707,daisy,97,98,669,800,766,898
20,0344-6782/2021-06-21/08/0344-6782_2021-06-21T08-20-09Z.jpg,508,CONFIG002,1,0,0.9158380031585693,daisy,99,102,1233,1048,1332,1150
20,0344-6782/2021-06-21/08/0344-6782_2021-06-21T08-20-09Z.jpg,508,CONFIG002,2,0,0.9129217863082886,daisy,97,99,840,677,937,776
20,0344-6782/2021-06-21/08/0344-6782_2021-06-21T08-20-09Z.jpg,508,CONFIG002,3,0,0.9127055406570435,daisy,83,94,1127,926,1210,1020
20,0344-6782/2021-06-21/08/0344-6782_2021-06-21T08-20-09Z.jpg,508,CONFIG002,4,0,0.909366250038147,daisy,81,77,792,609,873,686
20,0344-6782/2021-06-21/08/0344-6782_2021-06-21T08-20-09Z.jpg,508,CONFIG002,5,0,0.9036979675292969,daisy,93,85,1135,538,1228,623
20,0344-6782/2021-06-21/08/0344-6782_2021-06-21T08-20-09Z.jpg,508,CONFIG002,6,0,0.9014015793800354,daisy,88,82,1405,649,1493,731
20,0344-6782/2021-06-21/08/0344-6782_2021-06-21T08-20-09Z.jpg,508,CONFIG002,7,0,0.9011680483818054,daisy,100,101,1373,966,1473,1067
20,0344-6782/2021-06-21/08/0344-6782_2021-06-21T08-20-09Z.jpg,508,CONFIG002,8,0,0.8991875648498535,daisy,85,101,960,960,1045,1061
20,0344-6782/2021-06-21/08/0344-6782_2021-06-21T08-20-09Z.jpg,508,CONFIG002,9,0,0.8975921273231506,daisy,79,81,1221,252,1300,333
20,0344-6782/2021-06-21/08/0344-6782_2021-06-21T08-20-09Z.jpg,508,CONFIG002,10,0,0.8968119621276855,daisy,87,81,1189,342,1276,423
20,0344-6782/2021-06-21/08/0344-6782_2021-06-21T08-20-09Z.jpg,508,CONFIG002,11,0,0.893250584602356,daisy,84,79,1280,526,1364,605
20,0344-6782/2021-06-21/08/0344-6782_2021-06-21T08-20-09Z.jpg,508,CONFIG002,12,0,0.8923018574714661,daisy,75,83,975,870,1050,953
20,0344-6782/2021-06-21/08/0344-6782_2021-06-21T08-20-09Z.jpg,508,CONFIG002,13,0,0.8898022174835205,daisy,79,79,853,891,932,970
20,0344-6782/2021-06-21/08/0344-6782_2021-06-21T08-20-09Z.jpg,508,CONFIG002,14,0,0.8891055583953857,daisy,98,98,1223,621,1321,719
20,0344-6782/2021-06-21/08/0344-6782_2021-06-21T08-20-09Z.jpg,508,CONFIG002,15,0,0.8861352205276489,daisy,85,76,1314,363,1399,439
20,0344-6782/2021-06-21/08/0344-6782_2021-06-21T08-20-09Z.jpg,508,CONFIG002,16,0,0.8801709413528442,daisy,78,87,880,837,958,924
20,0344-6782/2021-06-21/08/0344-6782_2021-06-21T08-20-09Z.jpg,508,CONFIG002,17,0,0.8732023239135742,daisy,93,85,1138,430,1231,515
20,0344-6782/2021-06-21/08/0344-6782_2021-06-21T08-20-09Z.jpg,508,CONFIG002,18,0,0.8621253967285156,daisy,87,85,1333,637,1420,722
20,0344-6782/2021-06-21/08/0344-6782_2021-06-21T08-20-09Z.jpg,508,CONFIG002,19,0,0.8565011024475098,daisy,73,78,1123,604,1196,682
20,0344-6782/2021-06-21/08/0344-6782_2021-06-21T08-20-09Z.jpg,508,CONFIG002,20,0,0.8501046895980835,daisy,70,68,1219,402,1289,470
20,0344-6782/2021-06-21/08/0344-6782_2021-06-21T08-20-09Z.jpg,508,CONFIG002,21,0,0.8362451791763306,daisy,79,79,1080,614,1159,693
20,0344-6782/2021-06-21/08/0344-6782_2021-06-21T08-20-09Z.jpg,508,CONFIG002,22,0,0.8012794852256775,daisy,68,66,1016,686,1084,752
20,0344-6782/2021-06-21/08/0344-6782_2021-06-21T08-20-09Z.jpg,508,CONFIG002,23,0,0.5991994142532349,daisy,77,58,1083,590,1160,648
20,0344-6782/2021-06-21/08/0344-6782_2021-06-21T08-20-09Z.jpg,508,CONFIG002,24,0,0.5462751388549805,daisy,79,84,1097,605,1176,689
20,0344-6782/2021-06-21/08/0344-6782_2021-06-21T08-20-09Z.jpg,508,CONFIG002,25,0,0.5089620351791382,daisy,58,60,999,701,1057,761
21,0344-6782/2021-06-21/08/0344-6782_2021-06-21T08-54-59Z.jpg,509,CONFIG002,0,0,0.9201361536979675,daisy,95,99,845,679,940,778
21,0344-6782/2021-06-21/08/0344-6782_2021-06-21T08-54-59Z.jpg,509,CONFIG002,1,0,0.9115891456604004,daisy,83,79,791,611,874,690
21,0344-6782/2021-06-21/08/0344-6782_2021-06-21T08-54-59Z.jpg,509,CONFIG002,2,0,0.9111194610595703,daisy,99,94,672,800,771,894
21,0344-6782/2021-06-21/08/0344-6782_2021-06-21T08-54-59Z.jpg,509,CONFIG002,3,0,0.9064969420433044,daisy,80,81,1220,252,1300,333
21,0344-6782/2021-06-21/08/0344-6782_2021-06-21T08-54-59Z.jpg,509,CONFIG002,4,0,0.9040529727935791,daisy,97,99,1246,1047,1343,1146
21,0344-6782/2021-06-21/08/0344-6782_2021-06-21T08-54-59Z.jpg,509,CONFIG002,5,0,0.9030106663703918,daisy,84,89,1133,923,1217,1012
21,0344-6782/2021-06-21/08/0344-6782_2021-06-21T08-54-59Z.jpg,509,CONFIG002,6,0,0.902054488658905,daisy,78,86,978,869,1056,955
21,0344-6782/2021-06-21/08/0344-6782_2021-06-21T08-54-59Z.jpg,509,CONFIG002,7,0,0.9006683826446533,daisy,94,87,1138,539,1232,626
21,0344-6782/2021-06-21/08/0344-6782_2021-06-21T08-54-59Z.jpg,509,CONFIG002,8,0,0.8997438549995422,daisy,89,82,1273,526,1362,608
21,0344-6782/2021-06-21/08/0344-6782_2021-06-21T08-54-59Z.jpg,509,CONFIG002,9,0,0.8933796286582947,daisy,90,79,1186,347,1276,426
21,0344-6782/2021-06-21/08/0344-6782_2021-06-21T08-54-59Z.jpg,509,CONFIG002,10,0,0.8920565247535706,daisy,80,80,855,888,935,968
21,0344-6782/2021-06-21/08/0344-6782_2021-06-21T08-54-59Z.jpg,509,CONFIG002,11,0,0.8896066546440125,daisy,83,75,1326,368,1409,443
21,0344-6782/2021-06-21/08/0344-6782_2021-06-21T08-54-59Z.jpg,509,CONFIG002,12,0,0.8850640654563904,daisy,87,85,1407,652,1494,737
21,0344-6782/2021-06-21/08/0344-6782_2021-06-21T08-54-59Z.jpg,509,CONFIG002,13,0,0.8839645981788635,daisy,97,97,1224,621,1321,718
21,0344-6782/2021-06-21/08/0344-6782_2021-06-21T08-54-59Z.jpg,509,CONFIG002,14,0,0.8834130167961121,daisy,86,85,1333,638,1419,723
21,0344-6782/2021-06-21/08/0344-6782_2021-06-21T08-54-59Z.jpg,509,CONFIG002,15,0,0.8831688761711121,daisy,100,103,1381,959,1481,1062
21,0344-6782/2021-06-21/08/0344-6782_2021-06-21T08-54-59Z.jpg,509,CONFIG002,16,0,0.8788971304893494,daisy,81,98,963,958,1044,1056
21,0344-6782/2021-06-21/08/0344-6782_2021-06-21T08-54-59Z.jpg,509,CONFIG002,17,0,0.8409598469734192,daisy,71,65,1220,407,1291,472
21,0344-6782/2021-06-21/08/0344-6782_2021-06-21T08-54-59Z.jpg,509,CONFIG002,18,0,0.8356569409370422,daisy,83,88,879,836,962,924
21,0344-6782/2021-06-21/08/0344-6782_2021-06-21T08-54-59Z.jpg,509,CONFIG002,19,0,0.8321529030799866,daisy,74,78,1123,604,1197,682
21,0344-6782/2021-06-21/08/0344-6782_2021-06-21T08-54-59Z.jpg,509,CONFIG002,20,0,0.8167577981948853,daisy,76,77,1083,617,1159,694
21,0344-6782/2021-06-21/08/0344-6782_2021-06-21T08-54-59Z.jpg,509,CONFIG002,21,0,0.7733651995658875,daisy,67,66,1018,683,1085,749
21,0344-6782/2021-06-21/08/0344-6782_2021-06-21T08-54-59Z.jpg,509,CONFIG002,22,0,0.7296682596206665,daisy,81,74,1059,372,1140,446
21,0344-6782/2021-06-21/08/0344-6782_2021-06-21T08-54-59Z.jpg,509,CONFIG002,23,0,0.7016449570655823,daisy,64,74,1218,861,1282,935
21,0344-6782/2021-06-21/08/0344-6782_2021-06-21T08-54-59Z.jpg,509,CONFIG002,24,0,0.6972656846046448,daisy,86,86,1145,436,1231,522
21,0344-6782/2021-06-21/08/0344-6782_2021-06-21T08-54-59Z.jpg,509,CONFIG002,25,0,0.6807034611701965,daisy,78,71,1156,428,1234,499
21,0344-6782/2021-06-21/08/0344-6782_2021-06-21T08-54-59Z.jpg,509,CONFIG002,26,0,0.5503044128417969,daisy,74,65,1084,585,1158,650
22,0344-6782/2021-06-21/08/0344-6782_2021-06-21T08-55-17Z.jpg,510,CONFIG002,0,0,0.9144861698150635,daisy,96,97,844,674,940,771
22,0344-6782/2021-06-21/08/0344-6782_2021-06-21T08-55-17Z.jpg,510,CONFIG002,1,0,0.9075687527656555,daisy,87,84,1337,640,1424,724
22,0344-6782/2021-06-21/08/0344-6782_2021-06-21T08-55-17Z.jpg,510,CONFIG002,2,0,0.9048662781715393,daisy,79,81,1221,252,1300,333
22,0344-6782/2021-06-21/08/0344-6782_2021-06-21T08-55-17Z.jpg,510,CONFIG002,3,0,0.9046361446380615,daisy,84,88,1134,926,1218,1014
22,0344-6782/2021-06-21/08/0344-6782_2021-06-21T08-55-17Z.jpg,510,CONFIG002,4,0,0.9043158888816833,daisy,97,99,1246,1048,1343,1147
22,0344-6782/2021-06-21/08/0344-6782_2021-06-21T08-55-17Z.jpg,510,CONFIG002,5,0,0.9015728831291199,daisy,90,81,1274,527,1364,608
22,0344-6782/2021-06-21/08/0344-6782_2021-06-21T08-55-17Z.jpg,510,CONFIG002,6,0,0.89976966381073,daisy,77,86,979,868,1056,954
22,0344-6782/2021-06-21/08/0344-6782_2021-06-21T08-55-17Z.jpg,510,CONFIG002,7,0,0.8971723318099976,daisy,89,80,1189,346,1278,426
22,0344-6782/2021-06-21/08/0344-6782_2021-06-21T08-55-17Z.jpg,510,CONFIG002,8,0,0.8920131325721741,daisy,79,81,855,891,934,972
22,0344-6782/2021-06-21/08/0344-6782_2021-06-21T08-55-17Z.jpg,510,CONFIG002,9,0,0.8875787258148193,daisy,98,97,1226,621,1324,718
22,0344-6782/2021-06-21/08/0344-6782_2021-06-21T08-55-17Z.jpg,510,CONFIG002,10,0,0.8872541785240173,daisy,80,78,797,601,877,679
22,0344-6782/2021-06-21/08/0344-6782_2021-06-21T08-55-17Z.jpg,510,CONFIG002,11,0,0.887202799320221,daisy,83,73,1326,369,1409,442
22,0344-6782/2021-06-21/08/0344-6782_2021-06-21T08-55-17Z.jpg,510,CONFIG002,12,0,0.8847532868385315,daisy,94,85,1139,537,1233,622
22,0344-6782/2021-06-21/08/0344-6782_2021-06-21T08-55-17Z.jpg,510,CONFIG002,13,0,0.8809710741043091,daisy,96,90,669,798,765,888
22,0344-6782/2021-06-21/08/0344-6782_2021-06-21T08-55-17Z.jpg,510,CONFIG002,14,0,0.8807095885276794,daisy,99,103,1382,960,1481,1063
22,0344-6782/2021-06-21/08/0344-6782_2021-06-21T08-55-17Z.jpg,510,CONFIG002,15,0,0.8748127818107605,daisy,86,85,1408,652,1494,737
22,0344-6782/2021-06-21/08/0344-6782_2021-06-21T08-55-17Z.jpg,510,CONFIG002,16,0,0.8710036277770996,daisy,62,60,1022,689,1084,749
22,0344-6782/2021-06-21/08/0344-6782_2021-06-21T08-55-17Z.jpg,510,CONFIG002,17,0,0.8707550168037415,daisy,83,90,879,836,962,926
22,0344-6782/2021-06-21/08/0344-6782_2021-06-21T08-55-17Z.jpg,510,CONFIG002,18,0,0.8666651844978333,daisy,78,96,966,960,1044,1056
22,0344-6782/2021-06-21/08/0344-6782_2021-06-21T08-55-17Z.jpg,510,CONFIG002,19,0,0.8402045965194702,daisy,71,66,1220,406,1291,472
22,0344-6782/2021-06-21/08/0344-6782_2021-06-21T08-55-17Z.jpg,510,CONFIG002,20,0,0.8247952461242676,daisy,76,77,1086,614,1162,691
22,0344-6782/2021-06-21/08/0344-6782_2021-06-21T08-55-17Z.jpg,510,CONFIG002,21,0,0.7940318584442139,daisy,72,78,1124,598,1196,676
22,0344-6782/2021-06-21/08/0344-6782_2021-06-21T08-55-17Z.jpg,510,CONFIG002,22,0,0.7453632950782776,daisy,63,74,1221,861,1284,935
22,0344-6782/2021-06-21/08/0344-6782_2021-06-21T08-55-17Z.jpg,510,CONFIG002,23,0,0.7402316927909851,daisy,85,88,1146,435,1231,523
22,0344-6782/2021-06-21/08/0344-6782_2021-06-21T08-55-17Z.jpg,510,CONFIG002,24,0,0.6821521520614624,daisy,81,73,1059,372,1140,445
22,0344-6782/2021-06-21/08/0344-6782_2021-06-21T08-55-17Z.jpg,510,CONFIG002,25,0,0.5672890543937683,daisy,76,57,1087,588,1163,645
23,0344-6782/2021-06-21/08/0344-6782_2021-06-21T08-42-05Z.jpg,511,CONFIG002,0,0,0.9177592396736145,daisy,95,97,845,679,940,776
23,0344-6782/2021-06-21/08/0344-6782_2021-06-21T08-42-05Z.jpg,511,CONFIG002,1,0,0.9059189558029175,daisy,100,102,672,800,772,902
23,0344-6782/2021-06-21/08/0344-6782_2021-06-21T08-42-05Z.jpg,511,CONFIG002,2,0,0.9051632881164551,daisy,82,83,1218,249,1300,332
23,0344-6782/2021-06-21/08/0344-6782_2021-06-21T08-42-05Z.jpg,511,CONFIG002,3,0,0.9040841460227966,daisy,83,73,1322,367,1405,440
23,0344-6782/2021-06-21/08/0344-6782_2021-06-21T08-42-05Z.jpg,511,CONFIG002,4,0,0.9028458595275879,daisy,80,77,796,608,876,685
23,0344-6782/2021-06-21/08/0344-6782_2021-06-21T08-42-05Z.jpg,511,CONFIG002,5,0,0.9006103873252869,daisy,88,81,1405,650,1493,731
23,0344-6782/2021-06-21/08/0344-6782_2021-06-21T08-42-05Z.jpg,511,CONFIG002,6,0,0.8992178440093994,daisy,98,99,1244,1045,1342,1144
23,0344-6782/2021-06-21/08/0344-6782_2021-06-21T08-42-05Z.jpg,511,CONFIG002,7,0,0.8987874984741211,daisy,77,85,979,869,1056,954
23,0344-6782/2021-06-21/08/0344-6782_2021-06-21T08-42-05Z.jpg,511,CONFIG002,8,0,0.8980757594108582,daisy,93,85,1136,538,1229,623
23,0344-6782/2021-06-21/08/0344-6782_2021-06-21T08-42-05Z.jpg,511,CONFIG002,9,0,0.8938812017440796,daisy,89,81,1187,343,1276,424
23,0344-6782/2021-06-21/08/0344-6782_2021-06-21T08-42-05Z.jpg,511,CONFIG002,10,0,0.8918322920799255,daisy,79,81,856,888,935,969
23,0344-6782/2021-06-21/08/0344-6782_2021-06-21T08-42-05Z.jpg,511,CONFIG002,11,0,0.8892101645469666,daisy,86,92,1128,920,1214,1012
23,0344-6782/2021-06-21/08/0344-6782_2021-06-21T08-42-05Z.jpg,511,CONFIG002,12,0,0.886693000793457,daisy,102,105,1380,955,1482,1060
23,0344-6782/2021-06-21/08/0344-6782_2021-06-21T08-42-05Z.jpg,511,CONFIG002,13,0,0.8857168555259705,daisy,85,80,1276,524,1361,604
23,0344-6782/2021-06-21/08/0344-6782_2021-06-21T08-42-05Z.jpg,511,CONFIG002,14,0,0.8856418132781982,daisy,82,99,962,959,1044,1058
23,0344-6782/2021-06-21/08/0344-6782_2021-06-21T08-42-05Z.jpg,511,CONFIG002,15,0,0.8839948773384094,daisy,98,98,1225,616,1323,714
23,0344-6782/2021-06-21/08/0344-6782_2021-06-21T08-42-05Z.jpg,511,CONFIG002,16,0,0.8803126215934753,daisy,89,85,1327,628,1416,713
23,0344-6782/2021-06-21/08/0344-6782_2021-06-21T08-42-05Z.jpg,511,CONFIG002,17,0,0.862887442111969,daisy,71,76,1125,603,1196,679
23,0344-6782/2021-06-21/08/0344-6782_2021-06-21T08-42-05Z.jpg,511,CONFIG002,18,0,0.8512576818466187,daisy,87,85,1141,435,1228,520
23,0344-6782/2021-06-21/08/0344-6782_2021-06-21T08-42-05Z.jpg,511,CONFIG002,19,0,0.8510867953300476,daisy,70,66,1218,405,1288,471
23,0344-6782/2021-06-21/08/0344-6782_2021-06-21T08-42-05Z.jpg,511,CONFIG002,20,0,0.8441254496574402,daisy,83,90,880,836,963,926
23,0344-6782/2021-06-21/08/0344-6782_2021-06-21T08-42-05Z.jpg,511,CONFIG002,21,0,0.827186644077301,daisy,74,76,1085,615,1159,691
23,0344-6782/2021-06-21/08/0344-6782_2021-06-21T08-42-05Z.jpg,511,CONFIG002,22,0,0.8102431893348694,daisy,65,63,1019,686,1084,749
23,0344-6782/2021-06-21/08/0344-6782_2021-06-21T08-42-05Z.jpg,511,CONFIG002,23,0,0.6132533550262451,daisy,66,70,1217,861,1283,931
23,0344-6782/2021-06-21/08/0344-6782_2021-06-21T08-42-05Z.jpg,511,CONFIG002,24,0,0.5536618232727051,daisy,80,75,1058,370,1138,445
24,0344-6782/2021-06-21/08/0344-6782_2021-06-21T08-54-05Z.jpg,512,CONFIG002,0,0,0.9182112216949463,daisy,95,99,844,680,939,779
24,0344-6782/2021-06-21/08/0344-6782_2021-06-21T08-54-05Z.jpg,512,CONFIG002,1,0,0.9089410901069641,daisy,86,85,1335,640,1421,725
24,0344-6782/2021-06-21/08/0344-6782_2021-06-21T08-54-05Z.jpg,512,CONFIG002,2,0,0.9050144553184509,daisy,84,79,793,612,877,691
24,0344-6782/2021-06-21/08/0344-6782_2021-06-21T08-54-05Z.jpg,512,CONFIG002,3,0,0.9033719897270203,daisy,98,98,1244,1048,1342,1146
24,0344-6782/2021-06-21/08/0344-6782_2021-06-21T08-54-05Z.jpg,512,CONFIG002,4,0,0.9033628702163696,daisy,79,81,1220,253,1299,334
24,0344-6782/2021-06-21/08/0344-6782_2021-06-21T08-54-05Z.jpg,512,CONFIG002,5,0,0.8993722200393677,daisy,84,90,1133,923,1217,1013
24,0344-6782/2021-06-21/08/0344-6782_2021-06-21T08-54-05Z.jpg,512,CONFIG002,6,0,0.8990939259529114,daisy,89,82,1273,527,1362,609
24,0344-6782/2021-06-21/08/0344-6782_2021-06-21T08-54-05Z.jpg,512,CONFIG002,7,0,0.8985609412193298,daisy,78,86,977,869,1055,955
24,0344-6782/2021-06-21/08/0344-6782_2021-06-21T08-54-05Z.jpg,512,CONFIG002,8,0,0.8971331715583801,daisy,89,79,1186,347,1275,426
24,0344-6782/2021-06-21/08/0344-6782_2021-06-21T08-54-05Z.jpg,512,CONFIG002,9,0,0.8969005346298218,daisy,99,94,672,802,771,896
24,0344-6782/2021-06-21/08/0344-6782_2021-06-21T08-54-05Z.jpg,512,CONFIG002,10,0,0.8945732712745667,daisy,80,81,854,888,934,969
24,0344-6782/2021-06-21/08/0344-6782_2021-06-21T08-54-05Z.jpg,512,CONFIG002,11,0,0.8945050835609436,daisy,99,101,1380,961,1479,1062
24,0344-6782/2021-06-21/08/0344-6782_2021-06-21T08-54-05Z.jpg,512,CONFIG002,12,0,0.8925243020057678,daisy,82,75,1326,369,1408,444
24,0344-6782/2021-06-21/08/0344-6782_2021-06-21T08-54-05Z.jpg,512,CONFIG002,13,0,0.8918533325195312,daisy,93,87,1140,540,1233,627
24,0344-6782/2021-06-21/08/0344-6782_2021-06-21T08-54-05Z.jpg,512,CONFIG002,14,0,0.8913870453834534,daisy,88,85,1406,653,1494,738
24,0344-6782/2021-06-21/08/0344-6782_2021-06-21T08-54-05Z.jpg,512,CONFIG002,15,0,0.8837560415267944,daisy,97,95,1225,624,1322,719
24,0344-6782/2021-06-21/08/0344-6782_2021-06-21T08-54-05Z.jpg,512,CONFIG002,16,0,0.8790441751480103,daisy,81,98,963,958,1044,1056
24,0344-6782/2021-06-21/08/0344-6782_2021-06-21T08-54-05Z.jpg,512,CONFIG002,17,0,0.8569392561912537,daisy,84,91,878,835,962,926
24,0344-6782/2021-06-21/08/0344-6782_2021-06-21T08-54-05Z.jpg,512,CONFIG002,18,0,0.8478817343711853,daisy,70,65,1220,408,1290,473
24,0344-6782/2021-06-21/08/0344-6782_2021-06-21T08-54-05Z.jpg,512,CONFIG002,19,0,0.8343977928161621,daisy,75,78,1121,604,1196,682
24,0344-6782/2021-06-21/08/0344-6782_2021-06-21T08-54-05Z.jpg,512,CONFIG002,20,0,0.8149417042732239,daisy,77,77,1082,617,1159,694
24,0344-6782/2021-06-21/08/0344-6782_2021-06-21T08-54-05Z.jpg,512,CONFIG002,21,0,0.8016060590744019,daisy,66,64,1017,686,1083,750
24,0344-6782/2021-06-21/08/0344-6782_2021-06-21T08-54-05Z.jpg,512,CONFIG002,22,0,0.7918182611465454,daisy,80,75,1059,373,1139,448
24,0344-6782/2021-06-21/08/0344-6782_2021-06-21T08-54-05Z.jpg,512,CONFIG002,23,0,0.7330061793327332,daisy,87,88,1144,434,1231,522
24,0344-6782/2021-06-21/08/0344-6782_2021-06-21T08-54-05Z.jpg,512,CONFIG002,24,0,0.5177720785140991,daisy,75,65,1083,585,1158,650
25,0344-6782/2021-06-21/08/0344-6782_2021-06-21T08-01-02Z.jpg,513,CONFIG002,0,0,0.932625949382782,daisy,97,96,666,798,763,894
25,0344-6782/2021-06-21/08/0344-6782_2021-06-21T08-01-02Z.jpg,513,CONFIG002,1,0,0.9317224621772766,daisy,87,95,1127,928,1214,1023
25,0344-6782/2021-06-21/08/0344-6782_2021-06-21T08-01-02Z.jpg,513,CONFIG002,2,0,0.9250987768173218,daisy,101,97,1374,975,1475,1072
25,0344-6782/2021-06-21/08/0344-6782_2021-06-21T08-01-02Z.jpg,513,CONFIG002,3,0,0.9176508784294128,daisy,95,86,1134,533,1229,619
25,0344-6782/2021-06-21/08/0344-6782_2021-06-21T08-01-02Z.jpg,513,CONFIG002,4,0,0.9083859920501709,daisy,100,105,1228,1049,1328,1154
25,0344-6782/2021-06-21/08/0344-6782_2021-06-21T08-01-02Z.jpg,513,CONFIG002,5,0,0.907362699508667,daisy,82,75,1284,522,1366,597
25,0344-6782/2021-06-21/08/0344-6782_2021-06-21T08-01-02Z.jpg,513,CONFIG002,6,0,0.9072872400283813,daisy,97,99,837,676,934,775
25,0344-6782/2021-06-21/08/0344-6782_2021-06-21T08-01-02Z.jpg,513,CONFIG002,7,0,0.9069028496742249,daisy,83,79,791,601,874,680
25,0344-6782/2021-06-21/08/0344-6782_2021-06-21T08-01-02Z.jpg,513,CONFIG002,8,0,0.9061794877052307,daisy,77,85,973,871,1050,956
25,0344-6782/2021-06-21/08/0344-6782_2021-06-21T08-01-02Z.jpg,513,CONFIG002,9,0,0.9018121957778931,daisy,82,86,1206,846,1288,932
25,0344-6782/2021-06-21/08/0344-6782_2021-06-21T08-01-02Z.jpg,513,CONFIG002,10,0,0.898367166519165,daisy,84,100,962,962,1046,1062
25,0344-6782/2021-06-21/08/0344-6782_2021-06-21T08-01-02Z.jpg,513,CONFIG002,11,0,0.8969878554344177,daisy,93,82,1193,338,1286,420
25,0344-6782/2021-06-21/08/0344-6782_2021-06-21T08-01-02Z.jpg,513,CONFIG002,12,0,0.8958876729011536,daisy,80,80,852,893,932,973
25,0344-6782/2021-06-21/08/0344-6782_2021-06-21T08-01-02Z.jpg,513,CONFIG002,13,0,0.8927658200263977,daisy,88,85,1405,643,1493,728
25,0344-6782/2021-06-21/08/0344-6782_2021-06-21T08-01-02Z.jpg,513,CONFIG002,14,0,0.887011706829071,daisy,87,75,1302,360,1389,435
25,0344-6782/2021-06-21/08/0344-6782_2021-06-21T08-01-02Z.jpg,513,CONFIG002,15,0,0.8805620074272156,daisy,100,96,1217,615,1317,711
25,0344-6782/2021-06-21/08/0344-6782_2021-06-21T08-01-02Z.jpg,513,CONFIG002,16,0,0.8782574534416199,daisy,86,78,1144,426,1230,504
25,0344-6782/2021-06-21/08/0344-6782_2021-06-21T08-01-02Z.jpg,513,CONFIG002,17,0,0.8778284788131714,daisy,76,88,880,837,956,925
25,0344-6782/2021-06-21/08/0344-6782_2021-06-21T08-01-02Z.jpg,513,CONFIG002,18,0,0.8734990954399109,daisy,77,80,1224,252,1301,332
25,0344-6782/2021-06-21/08/0344-6782_2021-06-21T08-01-02Z.jpg,513,CONFIG002,19,0,0.8568362593650818,daisy,85,86,1332,632,1417,718
25,0344-6782/2021-06-21/08/0344-6782_2021-06-21T08-01-02Z.jpg,513,CONFIG002,20,0,0.8502293825149536,daisy,68,68,1224,399,1292,467
25,0344-6782/2021-06-21/08/0344-6782_2021-06-21T08-01-02Z.jpg,513,CONFIG002,21,0,0.8394080996513367,daisy,76,78,1082,612,1158,690
25,0344-6782/2021-06-21/08/0344-6782_2021-06-21T08-01-02Z.jpg,513,CONFIG002,22,0,0.8366645574569702,daisy,68,75,1123,602,1191,677
25,0344-6782/2021-06-21/08/0344-6782_2021-06-21T08-01-02Z.jpg,513,CONFIG002,23,0,0.828051745891571,daisy,68,65,1016,686,1084,751
26,0344-6782/2021-06-21/08/0344-6782_2021-06-21T08-06-21Z.jpg,514,CONFIG002,0,0,0.9244606494903564,daisy,83,77,799,606,882,683
26,0344-6782/2021-06-21/08/0344-6782_2021-06-21T08-06-21Z.jpg,514,CONFIG002,1,0,0.922001838684082,daisy,93,97,673,801,766,898
26,0344-6782/2021-06-21/08/0344-6782_2021-06-21T08-06-21Z.jpg,514,CONFIG002,2,0,0.9208770394325256,daisy,83,90,1142,928,1225,1018
26,0344-6782/2021-06-21/08/0344-6782_2021-06-21T08-06-21Z.jpg,514,CONFIG002,3,0,0.9065942764282227,daisy,76,87,978,869,1054,956
26,0344-6782/2021-06-21/08/0344-6782_2021-06-21T08-06-21Z.jpg,514,CONFIG002,4,0,0.8978972434997559,daisy,88,83,1408,644,1496,727
26,0344-6782/2021-06-21/08/0344-6782_2021-06-21T08-06-21Z.jpg,514,CONFIG002,5,0,0.8976063132286072,daisy,79,80,857,892,936,972
26,0344-6782/2021-06-21/08/0344-6782_2021-06-21T08-06-21Z.jpg,514,CONFIG002,6,0,0.8965149521827698,daisy,85,78,1286,523,1371,601
26,0344-6782/2021-06-21/08/0344-6782_2021-06-21T08-06-21Z.jpg,514,CONFIG002,7,0,0.8948100805282593,daisy,89,103,963,962,1052,1065
26,0344-6782/2021-06-21/08/0344-6782_2021-06-21T08-06-21Z.jpg,514,CONFIG002,8,0,0.8944616317749023,daisy,98,101,1388,963,1486,1064
26,0344-6782/2021-06-21/08/0344-6782_2021-06-21T08-06-21Z.jpg,514,CONFIG002,9,0,0.8875730633735657,daisy,99,94,1229,616,1328,710
26,0344-6782/2021-06-21/08/0344-6782_2021-06-21T08-06-21Z.jpg,514,CONFIG002,10,0,0.8869154453277588,daisy,95,100,848,670,943,770
26,0344-6782/2021-06-21/08/0344-6782_2021-06-21T08-06-21Z.jpg,514,CONFIG002,11,0,0.8821761012077332,daisy,83,85,1341,635,1424,720
26,0344-6782/2021-06-21/08/0344-6782_2021-06-21T08-06-21Z.jpg,514,CONFIG002,12,0,0.8802714943885803,daisy,97,108,1240,1045,1337,1153
26,0344-6782/2021-06-21/08/0344-6782_2021-06-21T08-06-21Z.jpg,514,CONFIG002,13,0,0.879790186882019,daisy,89,83,1201,339,1290,422
26,0344-6782/2021-06-21/08/0344-6782_2021-06-21T08-06-21Z.jpg,514,CONFIG002,14,0,0.8780014514923096,daisy,67,60,1019,692,1086,752
26,0344-6782/2021-06-21/08/0344-6782_2021-06-21T08-06-21Z.jpg,514,CONFIG002,15,0,0.8714212775230408,daisy,66,67,1228,399,1294,466
26,0344-6782/2021-06-21/08/0344-6782_2021-06-21T08-06-21Z.jpg,514,CONFIG002,16,0,0.8704991340637207,daisy,87,73,1306,361,1393,434
26,0344-6782/2021-06-21/08/0344-6782_2021-06-21T08-06-21Z.jpg,514,CONFIG002,17,0,0.8627161383628845,daisy,93,84,1144,535,1237,619
26,0344-6782/2021-06-21/08/0344-6782_2021-06-21T08-06-21Z.jpg,514,CONFIG002,18,0,0.8548780679702759,daisy,89,81,1146,427,1235,508
26,0344-6782/2021-06-21/08/0344-6782_2021-06-21T08-06-21Z.jpg,514,CONFIG002,19,0,0.8530827164649963,daisy,72,74,1226,847,1298,921
26,0344-6782/2021-06-21/08/0344-6782_2021-06-21T08-06-21Z.jpg,514,CONFIG002,20,0,0.8455274105072021,daisy,80,88,881,838,961,926
26,0344-6782/2021-06-21/08/0344-6782_2021-06-21T08-06-21Z.jpg,514,CONFIG002,21,0,0.8454043865203857,daisy,78,81,1227,251,1305,332
26,0344-6782/2021-06-21/08/0344-6782_2021-06-21T08-06-21Z.jpg,514,CONFIG002,22,0,0.8275409936904907,daisy,77,79,1090,606,1167,685
26,0344-6782/2021-06-21/08/0344-6782_2021-06-21T08-06-21Z.jpg,514,CONFIG002,23,0,0.7258307933807373,daisy,67,76,1132,601,1199,677
26,0344-6782/2021-06-21/08/0344-6782_2021-06-21T08-06-21Z.jpg,514,CONFIG002,24,0,0.5973476767539978,daisy,71,77,1116,605,1187,682
27,0344-6782/2021-06-21/08/0344-6782_2021-06-21T08-14-27Z.jpg,515,CONFIG002,0,0,0.9340907335281372,daisy,99,100,1240,1044,1339,1144
27,0344-6782/2021-06-21/08/0344-6782_2021-06-21T08-14-27Z.jpg,515,CONFIG002,1,0,0.9110305905342102,daisy,95,96,844,675,939,771
27,0344-6782/2021-06-21/08/0344-6782_2021-06-21T08-14-27Z.jpg,515,CONFIG002,2,0,0.9075406193733215,daisy,76,87,978,869,1054,956
27,0344-6782/2021-06-21/08/0344-6782_2021-06-21T08-14-27Z.jpg,515,CONFIG002,3,0,0.9022607207298279,daisy,96,98,670,795,766,893
27,0344-6782/2021-06-21/08/0344-6782_2021-06-21T08-14-27Z.jpg,515,CONFIG002,4,0,0.8973304033279419,daisy,90,103,962,960,1052,1063
27,0344-6782/2021-06-21/08/0344-6782_2021-06-21T08-14-27Z.jpg,515,CONFIG002,5,0,0.8970654010772705,daisy,89,81,1191,340,1280,421
27,0344-6782/2021-06-21/08/0344-6782_2021-06-21T08-14-27Z.jpg,515,CONFIG002,6,0,0.8966495990753174,daisy,79,80,856,889,935,969
27,0344-6782/2021-06-21/08/0344-6782_2021-06-21T08-14-27Z.jpg,515,CONFIG002,7,0,0.8945026397705078,daisy,88,89,1325,622,1413,711
27,0344-6782/2021-06-21/08/0344-6782_2021-06-21T08-14-27Z.jpg,515,CONFIG002,8,0,0.8899010419845581,daisy,79,88,1134,923,1213,1011
27,0344-6782/2021-06-21/08/0344-6782_2021-06-21T08-14-27Z.jpg,515,CONFIG002,9,0,0.8859153985977173,daisy,83,77,1283,524,1366,601
27,0344-6782/2021-06-21/08/0344-6782_2021-06-21T08-14-27Z.jpg,515,CONFIG002,10,0,0.8838580250740051,daisy,78,81,1223,252,1301,333
27,0344-6782/2021-06-21/08/0344-6782_2021-06-21T08-14-27Z.jpg,515,CONFIG002,11,0,0.8834487199783325,daisy,86,83,1402,643,1488,726
27,0344-6782/2021-06-21/08/0344-6782_2021-06-21T08-14-27Z.jpg,515,CONFIG002,12,0,0.8810665011405945,daisy,87,75,1308,362,1395,437
27,0344-6782/2021-06-21/08/0344-6782_2021-06-21T08-14-27Z.jpg,515,CONFIG002,13,0,0.8773963451385498,daisy,96,103,1387,953,1483,1056
27,0344-6782/2021-06-21/08/0344-6782_2021-06-21T08-14-27Z.jpg,515,CONFIG002,14,0,0.8643980026245117,daisy,90,81,1140,429,1230,510
27,0344-6782/2021-06-21/08/0344-6782_2021-06-21T08-14-27Z.jpg,515,CONFIG002,15,0,0.8637334704399109,daisy,100,96,1220,614,1320,710
27,0344-6782/2021-06-21/08/0344-6782_2021-06-21T08-14-27Z.jpg,515,CONFIG002,16,0,0.8620448708534241,daisy,82,79,798,599,880,678
27,0344-6782/2021-06-21/08/0344-6782_2021-06-21T08-14-27Z.jpg,515,CONFIG002,17,0,0.8556486368179321,daisy,82,93,879,837,961,930
27,0344-6782/2021-06-21/08/0344-6782_2021-06-21T08-14-27Z.jpg,515,CONFIG002,18,0,0.8552940487861633,daisy,91,83,1139,533,1230,616
27,0344-6782/2021-06-21/08/0344-6782_2021-06-21T08-14-27Z.jpg,515,CONFIG002,19,0,0.8506613373756409,daisy,67,62,1018,691,1085,753
27,0344-6782/2021-06-21/08/0344-6782_2021-06-21T08-14-27Z.jpg,515,CONFIG002,20,0,0.8438702821731567,daisy,70,75,1127,605,1197,680
27,0344-6782/2021-06-21/08/0344-6782_2021-06-21T08-14-27Z.jpg,515,CONFIG002,21,0,0.8352562785148621,daisy,68,67,1221,400,1289,467
27,0344-6782/2021-06-21/08/0344-6782_2021-06-21T08-14-27Z.jpg,515,CONFIG002,22,0,0.8198179602622986,daisy,74,76,1087,614,1161,690
27,0344-6782/2021-06-21/08/0344-6782_2021-06-21T08-14-27Z.jpg,515,CONFIG002,23,0,0.8057966232299805,daisy,80,62,1087,582,1167,644
27,0344-6782/2021-06-21/08/0344-6782_2021-06-21T08-14-27Z.jpg,515,CONFIG002,24,0,0.6808642148971558,daisy,67,73,1218,852,1285,925
28,0344-6782/2021-06-21/08/0344-6782_2021-06-21T08-07-57Z.jpg,516,CONFIG002,0,0,0.9211962819099426,daisy,93,98,671,797,764,895
28,0344-6782/2021-06-21/08/0344-6782_2021-06-21T08-07-57Z.jpg,516,CONFIG002,1,0,0.9106970429420471,daisy,97,97,843,669,940,766
28,0344-6782/2021-06-21/08/0344-6782_2021-06-21T08-07-57Z.jpg,516,CONFIG002,2,0,0.9058455228805542,daisy,77,87,977,869,1054,956
28,0344-6782/2021-06-21/08/0344-6782_2021-06-21T08-07-57Z.jpg,516,CONFIG002,3,0,0.9055986404418945,daisy,83,92,1137,924,1220,1016
28,0344-6782/2021-06-21/08/0344-6782_2021-06-21T08-07-57Z.jpg,516,CONFIG002,4,0,0.904337465763092,daisy,99,105,1237,1045,1336,1150
28,0344-6782/2021-06-21/08/0344-6782_2021-06-21T08-07-57Z.jpg,516,CONFIG002,5,0,0.9016968607902527,daisy,90,103,962,960,1052,1063
28,0344-6782/2021-06-21/08/0344-6782_2021-06-21T08-07-57Z.jpg,516,CONFIG002,6,0,0.898829996585846,daisy,92,82,1195,338,1287,420
28,0344-6782/2021-06-21/08/0344-6782_2021-06-21T08-07-57Z.jpg,516,CONFIG002,7,0,0.895418643951416,daisy,86,75,1311,363,1397,438
28,0344-6782/2021-06-21/08/0344-6782_2021-06-21T08-07-57Z.jpg,516,CONFIG002,8,0,0.8954141139984131,daisy,98,103,1386,962,1484,1065
28,0344-6782/2021-06-21/08/0344-6782_2021-06-21T08-07-57Z.jpg,516,CONFIG002,9,0,0.8919010162353516,daisy,85,77,1282,523,1367,600
28,0344-6782/2021-06-21/08/0344-6782_2021-06-21T08-07-57Z.jpg,516,CONFIG002,10,0,0.8915854692459106,daisy,80,82,854,889,934,971
28,0344-6782/2021-06-21/08/0344-6782_2021-06-21T08-07-57Z.jpg,516,CONFIG002,11,0,0.8885909914970398,daisy,86,83,1404,643,1490,726
28,0344-6782/2021-06-21/08/0344-6782_2021-06-21T08-07-57Z.jpg,516,CONFIG002,12,0,0.8862382769584656,daisy,79,82,1222,250,1301,332
28,0344-6782/2021-06-21/08/0344-6782_2021-06-21T08-07-57Z.jpg,516,CONFIG002,13,0,0.8811394572257996,daisy,87,88,1335,629,1422,717
28,0344-6782/2021-06-21/08/0344-6782_2021-06-21T08-07-57Z.jpg,516,CONFIG002,14,0,0.8681361079216003,daisy,78,76,798,597,876,673
28,0344-6782/2021-06-21/08/0344-6782_2021-06-21T08-07-57Z.jpg,516,CONFIG002,15,0,0.8651992082595825,daisy,67,61,1018,690,1085,751
28,0344-6782/2021-06-21/08/0344-6782_2021-06-21T08-07-57Z.jpg,516,CONFIG002,16,0,0.8608455657958984,daisy,99,94,1224,613,1323,707
28,0344-6782/2021-06-21/08/0344-6782_2021-06-21T08-07-57Z.jpg,516,CONFIG002,17,0,0.8496803641319275,daisy,67,67,1225,399,1292,466
28,0344-6782/2021-06-21/08/0344-6782_2021-06-21T08-07-57Z.jpg,516,CONFIG002,18,0,0.8494086861610413,daisy,90,81,1142,428,1232,509
28,0344-6782/2021-06-21/08/0344-6782_2021-06-21T08-07-57Z.jpg,516,CONFIG002,19,0,0.8468354344367981,daisy,72,76,1221,848,1293,924
28,0344-6782/2021-06-21/08/0344-6782_2021-06-21T08-07-57Z.jpg,516,CONFIG002,20,0,0.8439067006111145,daisy,81,91,880,838,961,929
28,0344-6782/2021-06-21/08/0344-6782_2021-06-21T08-07-57Z.jpg,516,CONFIG002,21,0,0.815581202507019,daisy,79,79,1089,607,1168,686
28,0344-6782/2021-06-21/08/0344-6782_2021-06-21T08-07-57Z.jpg,516,CONFIG002,22,0,0.8007611036300659,daisy,91,83,1142,534,1233,617
28,0344-6782/2021-06-21/08/0344-6782_2021-06-21T08-07-57Z.jpg,516,CONFIG002,23,0,0.6831967234611511,daisy,74,79,1112,602,1186,681
28,0344-6782/2021-06-21/08/0344-6782_2021-06-21T08-07-57Z.jpg,516,CONFIG002,24,0,0.5315466523170471,daisy,75,56,1089,578,1164,634
28,0344-6782/2021-06-21/08/0344-6782_2021-06-21T08-07-57Z.jpg,516,CONFIG002,25,0,0.5085985660552979,daisy,67,75,1128,599,1195,674
29,0344-6782/2021-06-21/08/0344-6782_2021-06-21T08-27-22Z.jpg,517,CONFIG002,0,0,0.9294373393058777,daisy,99,98,671,799,770,897
29,0344-6782/2021-06-21/08/0344-6782_2021-06-21T08-27-22Z.jpg,517,CONFIG002,1,0,0.9168146252632141,daisy,95,98,844,678,939,776
29,0344-6782/2021-06-21/08/0344-6782_2021-06-21T08-27-22Z.jpg,517,CONFIG002,2,0,0.9160916805267334,daisy,84,94,1131,923,1215,1017
29,0344-6782/2021-06-21/08/0344-6782_2021-06-21T08-27-22Z.jpg,517,CONFIG002,3,0,0.9039268493652344,daisy,88,80,1406,650,1494,730
29,0344-6782/2021-06-21/08/0344-6782_2021-06-21T08-27-22Z.jpg,517,CONFIG002,4,0,0.9020119905471802,daisy,87,101,961,960,1048,1061
29,0344-6782/2021-06-21/08/0344-6782_2021-06-21T08-27-22Z.jpg,517,CONFIG002,5,0,0.8975892066955566,daisy,80,76,796,610,876,686
29,0344-6782/2021-06-21/08/0344-6782_2021-06-21T08-27-22Z.jpg,517,CONFIG002,6,0,0.8963741064071655,daisy,97,98,1240,1048,1337,1146
29,0344-6782/2021-06-21/08/0344-6782_2021-06-21T08-27-22Z.jpg,517,CONFIG002,7,0,0.8954654932022095,daisy,86,75,1317,364,1403,439
29,0344-6782/2021-06-21/08/0344-6782_2021-06-21T08-27-22Z.jpg,517,CONFIG002,8,0,0.8950710892677307,daisy,89,81,1191,343,1280,424
29,0344-6782/2021-06-21/08/0344-6782_2021-06-21T08-27-22Z.jpg,517,CONFIG002,9,0,0.8935941457748413,daisy,79,84,978,870,1057,954
29,0344-6782/2021-06-21/08/0344-6782_2021-06-21T08-27-22Z.jpg,517,CONFIG002,10,0,0.8905653953552246,daisy,86,77,1279,526,1365,603
29,0344-6782/2021-06-21/08/0344-6782_2021-06-21T08-27-22Z.jpg,517,CONFIG002,11,0,0.8896634578704834,daisy,79,82,1223,251,1302,333
29,0344-6782/2021-06-21/08/0344-6782_2021-06-21T08-27-22Z.jpg,517,CONFIG002,12,0,0.8889762759208679,daisy,79,81,856,889,935,970
29,0344-6782/2021-06-21/08/0344-6782_2021-06-21T08-27-22Z.jpg,517,CONFIG002,13,0,0.885781466960907,daisy,99,102,1381,961,1480,1063
29,0344-6782/2021-06-21/08/0344-6782_2021-06-21T08-27-22Z.jpg,517,CONFIG002,14,0,0.8831092119216919,daisy,94,86,1140,536,1234,622
29,0344-6782/2021-06-21/08/0344-6782_2021-06-21T08-27-22Z.jpg,517,CONFIG002,15,0,0.8793541789054871,daisy,97,96,1225,621,1322,717
29,0344-6782/2021-06-21/08/0344-6782_2021-06-21T08-27-22Z.jpg,517,CONFIG002,16,0,0.8620445132255554,daisy,84,85,1336,637,1420,722
29,0344-6782/2021-06-21/08/0344-6782_2021-06-21T08-27-22Z.jpg,517,CONFIG002,17,0,0.8586187958717346,daisy,70,67,1219,403,1289,470
29,0344-6782/2021-06-21/08/0344-6782_2021-06-21T08-27-22Z.jpg,517,CONFIG002,18,0,0.8584660887718201,daisy,72,76,1126,604,1198,680
29,0344-6782/2021-06-21/08/0344-6782_2021-06-21T08-27-22Z.jpg,517,CONFIG002,19,0,0.852623462677002,daisy,93,87,1139,430,1232,517
29,0344-6782/2021-06-21/08/0344-6782_2021-06-21T08-27-22Z.jpg,517,CONFIG002,20,0,0.8523427844047546,daisy,64,61,1020,690,1084,751
29,0344-6782/2021-06-21/08/0344-6782_2021-06-21T08-27-22Z.jpg,517,CONFIG002,21,0,0.8352829813957214,daisy,83,91,879,836,962,927
29,0344-6782/2021-06-21/08/0344-6782_2021-06-21T08-27-22Z.jpg,517,CONFIG002,22,0,0.8203128576278687,daisy,75,77,1084,614,1159,691
29,0344-6782/2021-06-21/08/0344-6782_2021-06-21T08-27-22Z.jpg,517,CONFIG002,23,0,0.5375276803970337,daisy,76,57,1088,589,1164,646
30,0344-6782/2021-06-21/08/0344-6782_2021-06-21T08-45-23Z.jpg,518,CONFIG002,0,0,0.9154936075210571,daisy,96,98,842,679,938,777
30,0344-6782/2021-06-21/08/0344-6782_2021-06-21T08-45-23Z.jpg,518,CONFIG002,1,0,0.9113984704017639,daisy,98,97,670,799,768,896
30,0344-6782/2021-06-21/08/0344-6782_2021-06-21T08-45-23Z.jpg,518,CONFIG002,2,0,0.9108198285102844,daisy,83,78,792,612,875,690
30,0344-6782/2021-06-21/08/0344-6782_2021-06-21T08-45-23Z.jpg,518,CONFIG002,3,0,0.9062453508377075,daisy,80,82,1220,251,1300,333
30,0344-6782/2021-06-21/08/0344-6782_2021-06-21T08-45-23Z.jpg,518,CONFIG002,4,0,0.9060315489768982,daisy,92,85,1136,540,1228,625
30,0344-6782/2021-06-21/08/0344-6782_2021-06-21T08-45-23Z.jpg,518,CONFIG002,5,0,0.8988310694694519,daisy,79,84,977,871,1056,955
30,0344-6782/2021-06-21/08/0344-6782_2021-06-21T08-45-23Z.jpg,518,CONFIG002,6,0,0.8978409171104431,daisy,82,74,1324,368,1406,442
30,0344-6782/2021-06-21/08/0344-6782_2021-06-21T08-45-23Z.jpg,518,CONFIG002,7,0,0.8975405693054199,daisy,86,91,1129,923,1215,1014
30,0344-6782/2021-06-21/08/0344-6782_2021-06-21T08-45-23Z.jpg,518,CONFIG002,8,0,0.89751136302948,daisy,89,80,1188,344,1277,424
30,0344-6782/2021-06-21/08/0344-6782_2021-06-21T08-45-23Z.jpg,518,CONFIG002,9,0,0.8963873386383057,daisy,88,81,1274,526,1362,607
30,0344-6782/2021-06-21/08/0344-6782_2021-06-21T08-45-23Z.jpg,518,CONFIG002,10,0,0.8940278887748718,daisy,80,81,854,888,934,969
30,0344-6782/2021-06-21/08/0344-6782_2021-06-21T08-45-23Z.jpg,518,CONFIG002,11,0,0.8939505219459534,daisy,97,98,1243,1048,1340,1146
30,0344-6782/2021-06-21/08/0344-6782_2021-06-21T08-45-23Z.jpg,518,CONFIG002,12,0,0.887089192867279,daisy,82,100,960,959,1042,1059
30,0344-6782/2021-06-21/08/0344-6782_2021-06-21T08-45-23Z.jpg,518,CONFIG002,13,0,0.8842042088508606,daisy,100,102,1380,960,1480,1062
30,0344-6782/2021-06-21/08/0344-6782_2021-06-21T08-45-23Z.jpg,518,CONFIG002,14,0,0.8839590549468994,daisy,87,84,1407,651,1494,735
30,0344-6782/2021-06-21/08/0344-6782_2021-06-21T08-45-23Z.jpg,518,CONFIG002,15,0,0.8825604915618896,daisy,98,95,1221,622,1319,717
30,0344-6782/2021-06-21/08/0344-6782_2021-06-21T08-45-23Z.jpg,518,CONFIG002,16,0,0.8679274320602417,daisy,74,77,1121,604,1195,681
30,0344-6782/2021-06-21/08/0344-6782_2021-06-21T08-45-23Z.jpg,518,CONFIG002,17,0,0.8582414388656616,daisy,85,84,1330,633,1415,717
30,0344-6782/2021-06-21/08/0344-6782_2021-06-21T08-45-23Z.jpg,518,CONFIG002,18,0,0.8528039455413818,daisy,70,66,1218,405,1288,471
30,0344-6782/2021-06-21/08/0344-6782_2021-06-21T08-45-23Z.jpg,518,CONFIG002,19,0,0.8451007604598999,daisy,81,90,879,835,960,925
30,0344-6782/2021-06-21/08/0344-6782_2021-06-21T08-45-23Z.jpg,518,CONFIG002,20,0,0.82879239320755,daisy,77,78,1081,616,1158,694
30,0344-6782/2021-06-21/08/0344-6782_2021-06-21T08-45-23Z.jpg,518,CONFIG002,21,0,0.7762861251831055,daisy,68,70,1014,680,1082,750
30,0344-6782/2021-06-21/08/0344-6782_2021-06-21T08-45-23Z.jpg,518,CONFIG002,22,0,0.7634914517402649,daisy,83,76,1144,446,1227,522
30,0344-6782/2021-06-21/08/0344-6782_2021-06-21T08-45-23Z.jpg,518,CONFIG002,23,0,0.7139222621917725,daisy,82,75,1057,370,1139,445
30,0344-6782/2021-06-21/08/0344-6782_2021-06-21T08-45-23Z.jpg,518,CONFIG002,24,0,0.57673579454422,daisy,65,69,1214,863,1279,932
30,0344-6782/2021-06-21/08/0344-6782_2021-06-21T08-45-23Z.jpg,518,CONFIG002,25,0,0.5740392804145813,daisy,83,73,1151,428,1234,501
30,0344-6782/2021-06-21/08/0344-6782_2021-06-21T08-45-23Z.jpg,518,CONFIG002,26,0,0.5696789622306824,daisy,83,86,1101,603,1184,689
31,0344-6782/2021-06-21/08/0344-6782_2021-06-21T08-53-17Z.jpg,519,CONFIG002,0,0,0.9193854928016663,daisy,94,98,845,680,939,778
31,0344-6782/2021-06-21/08/0344-6782_2021-06-21T08-53-17Z.jpg,519,CONFIG002,1,0,0.9041295647621155,daisy,84,80,793,612,877,692
31,0344-6782/2021-06-21/08/0344-6782_2021-06-21T08-53-17Z.jpg,519,CONFIG002,2,0,0.9025946855545044,daisy,79,81,1220,253,1299,334
31,0344-6782/2021-06-21/08/0344-6782_2021-06-21T08-53-17Z.jpg,519,CONFIG002,3,0,0.9010262489318848,daisy,97,98,1244,1048,1341,1146
31,0344-6782/2021-06-21/08/0344-6782_2021-06-21T08-53-17Z.jpg,519,CONFIG002,4,0,0.8992037177085876,daisy,88,82,1273,527,1361,609
31,0344-6782/2021-06-21/08/0344-6782_2021-06-21T08-53-17Z.jpg,519,CONFIG002,5,0,0.8991100192070007,daisy,83,90,1133,923,1216,1013
31,0344-6782/2021-06-21/08/0344-6782_2021-06-21T08-53-17Z.jpg,519,CONFIG002,6,0,0.8970193266868591,daisy,78,85,977,869,1055,954
31,0344-6782/2021-06-21/08/0344-6782_2021-06-21T08-53-17Z.jpg,519,CONFIG002,7,0,0.8967009782791138,daisy,89,79,1186,347,1275,426
31,0344-6782/2021-06-21/08/0344-6782_2021-06-21T08-53-17Z.jpg,519,CONFIG002,8,0,0.8958442807197571,daisy,79,81,854,888,933,969
31,0344-6782/2021-06-21/08/0344-6782_2021-06-21T08-53-17Z.jpg,519,CONFIG002,9,0,0.8941327929496765,daisy,86,85,1333,639,1419,724
31,0344-6782/2021-06-21/08/0344-6782_2021-06-21T08-53-17Z.jpg,519,CONFIG002,10,0,0.8940040469169617,daisy,82,75,1326,369,1408,444
31,0344-6782/2021-06-21/08/0344-6782_2021-06-21T08-53-17Z.jpg,519,CONFIG002,11,0,0.8937029838562012,daisy,93,87,1139,540,1232,627
31,0344-6782/2021-06-21/08/0344-6782_2021-06-21T08-53-17Z.jpg,519,CONFIG002,12,0,0.8936412930488586,daisy,101,100,671,801,772,901
31,0344-6782/2021-06-21/08/0344-6782_2021-06-21T08-53-17Z.jpg,519,CONFIG002,13,0,0.8933495879173279,daisy,88,85,1406,653,1494,738
31,0344-6782/2021-06-21/08/0344-6782_2021-06-21T08-53-17Z.jpg,519,CONFIG002,14,0,0.8908844590187073,daisy,99,102,1380,960,1479,1062
31,0344-6782/2021-06-21/08/0344-6782_2021-06-21T08-53-17Z.jpg,519,CONFIG002,15,0,0.885404646396637,daisy,81,98,962,958,1043,1056
31,0344-6782/2021-06-21/08/0344-6782_2021-06-21T08-53-17Z.jpg,519,CONFIG002,16,0,0.8821126818656921,daisy,95,94,1226,624,1321,718
31,0344-6782/2021-06-21/08/0344-6782_2021-06-21T08-53-17Z.jpg,519,CONFIG002,17,0,0.8587201833724976,daisy,85,91,877,835,962,926
31,0344-6782/2021-06-21/08/0344-6782_2021-06-21T08-53-17Z.jpg,519,CONFIG002,18,0,0.8429877161979675,daisy,71,65,1219,407,1290,472
31,0344-6782/2021-06-21/08/0344-6782_2021-06-21T08-53-17Z.jpg,519,CONFIG002,19,0,0.8391366004943848,daisy,75,78,1122,604,1197,682
31,0344-6782/2021-06-21/08/0344-6782_2021-06-21T08-53-17Z.jpg,519,CONFIG002,20,0,0.8215597867965698,daisy,77,78,1082,616,1159,694
31,0344-6782/2021-06-21/08/0344-6782_2021-06-21T08-53-17Z.jpg,519,CONFIG002,21,0,0.8163454532623291,daisy,80,76,1059,372,1139,448
31,0344-6782/2021-06-21/08/0344-6782_2021-06-21T08-53-17Z.jpg,519,CONFIG002,22,0,0.7993360757827759,daisy,66,64,1017,686,1083,750
31,0344-6782/2021-06-21/08/0344-6782_2021-06-21T08-53-17Z.jpg,519,CONFIG002,23,0,0.7461068034172058,daisy,84,76,1145,447,1229,523
31,0344-6782/2021-06-21/08/0344-6782_2021-06-21T08-53-17Z.jpg,519,CONFIG002,24,0,0.6127786636352539,daisy,80,72,1153,428,1233,500
32,0344-6782/2021-06-21/08/0344-6782_2021-06-21T08-39-46Z.jpg,520,CONFIG002,0,0,0.9137040376663208,daisy,99,99,674,799,773,898
32,0344-6782/2021-06-21/08/0344-6782_2021-06-21T08-39-46Z.jpg,520,CONFIG002,1,0,0.9102035164833069,daisy,98,102,1246,1044,1344,1146
32,0344-6782/2021-06-21/08/0344-6782_2021-06-21T08-39-46Z.jpg,520,CONFIG002,2,0,0.905113697052002,daisy,97,95,846,678,943,773
32,0344-6782/2021-06-21/08/0344-6782_2021-06-21T08-39-46Z.jpg,520,CONFIG002,3,0,0.904471218585968,daisy,77,86,979,869,1056,955
32,0344-6782/2021-06-21/08/0344-6782_2021-06-21T08-39-46Z.jpg,520,CONFIG002,4,0,0.9024920463562012,daisy,79,82,1221,251,1300,333
32,0344-6782/2021-06-21/08/0344-6782_2021-06-21T08-39-46Z.jpg,520,CONFIG002,5,0,0.9013649225234985,daisy,81,78,800,610,881,688
32,0344-6782/2021-06-21/08/0344-6782_2021-06-21T08-39-46Z.jpg,520,CONFIG002,6,0,0.899161696434021,daisy,86,91,1132,922,1218,1013
32,0344-6782/2021-06-21/08/0344-6782_2021-06-21T08-39-46Z.jpg,520,CONFIG002,7,0,0.8971898555755615,daisy,81,72,1324,368,1405,440
32,0344-6782/2021-06-21/08/0344-6782_2021-06-21T08-39-46Z.jpg,520,CONFIG002,8,0,0.8964307904243469,daisy,90,82,1190,343,1280,425
32,0344-6782/2021-06-21/08/0344-6782_2021-06-21T08-39-46Z.jpg,520,CONFIG002,9,0,0.8934231996536255,daisy,92,85,1142,538,1234,623
32,0344-6782/2021-06-21/08/0344-6782_2021-06-21T08-39-46Z.jpg,520,CONFIG002,10,0,0.8884437680244446,daisy,86,79,1278,526,1364,605
32,0344-6782/2021-06-21/08/0344-6782_2021-06-21T08-39-46Z.jpg,520,CONFIG002,11,0,0.8880667090415955,daisy,88,82,1407,651,1495,733
32,0344-6782/2021-06-21/08/0344-6782_2021-06-21T08-39-46Z.jpg,520,CONFIG002,12,0,0.8863188028335571,daisy,98,98,1226,620,1324,718
32,0344-6782/2021-06-21/08/0344-6782_2021-06-21T08-39-46Z.jpg,520,CONFIG002,13,0,0.8831198811531067,daisy,79,81,858,888,937,969
32,0344-6782/2021-06-21/08/0344-6782_2021-06-21T08-39-46Z.jpg,520,CONFIG002,14,0,0.8754929900169373,daisy,87,84,1336,637,1423,721
32,0344-6782/2021-06-21/08/0344-6782_2021-06-21T08-39-46Z.jpg,520,CONFIG002,15,0,0.8723508715629578,daisy,96,103,1389,954,1485,1057
32,0344-6782/2021-06-21/08/0344-6782_2021-06-21T08-39-46Z.jpg,520,CONFIG002,16,0,0.86826491355896,daisy,82,98,963,961,1045,1059
32,0344-6782/2021-06-21/08/0344-6782_2021-06-21T08-39-46Z.jpg,520,CONFIG002,17,0,0.865738570690155,daisy,62,60,1022,690,1084,750
32,0344-6782/2021-06-21/08/0344-6782_2021-06-21T08-39-46Z.jpg,520,CONFIG002,18,0,0.8579702973365784,daisy,71,66,1217,404,1288,470
32,0344-6782/2021-06-21/08/0344-6782_2021-06-21T08-39-46Z.jpg,520,CONFIG002,19,0,0.8243423700332642,daisy,75,78,1086,613,1161,691
32,0344-6782/2021-06-21/08/0344-6782_2021-06-21T08-39-46Z.jpg,520,CONFIG002,20,0,0.8221960067749023,daisy,83,88,882,837,965,925
32,0344-6782/2021-06-21/08/0344-6782_2021-06-21T08-39-46Z.jpg,520,CONFIG002,21,0,0.8176689743995667,daisy,72,77,1129,603,1201,680
32,0344-6782/2021-06-21/08/0344-6782_2021-06-21T08-39-46Z.jpg,520,CONFIG002,22,0,0.7941962480545044,daisy,88,84,1145,433,1233,517
32,0344-6782/2021-06-21/08/0344-6782_2021-06-21T08-39-46Z.jpg,520,CONFIG002,23,0,0.7407012581825256,daisy,65,73,1221,859,1286,932
32,0344-6782/2021-06-21/08/0344-6782_2021-06-21T08-39-46Z.jpg,520,CONFIG002,24,0,0.5198530554771423,daisy,80,74,1058,372,1138,446
33,0344-6782/2021-06-21/08/0344-6782_2021-06-21T08-34-22Z.jpg,521,CONFIG002,0,0,0.9299267530441284,daisy,100,101,677,807,777,908
33,0344-6782/2021-06-21/08/0344-6782_2021-06-21T08-34-22Z.jpg,521,CONFIG002,1,0,0.915341854095459,daisy,98,96,846,678,944,774
33,0344-6782/2021-06-21/08/0344-6782_2021-06-21T08-34-22Z.jpg,521,CONFIG002,2,0,0.9140099287033081,daisy,100,102,1253,1044,1353,1146
33,0344-6782/2021-06-21/08/0344-6782_2021-06-21T08-34-22Z.jpg,521,CONFIG002,3,0,0.9070309400558472,daisy,76,85,981,871,1057,956
33,0344-6782/2021-06-21/08/0344-6782_2021-06-21T08-34-22Z.jpg,521,CONFIG002,4,0,0.9030988216400146,daisy,85,74,1319,366,1404,440
33,0344-6782/2021-06-21/08/0344-6782_2021-06-21T08-34-22Z.jpg,521,CONFIG002,5,0,0.8985701203346252,daisy,86,80,1280,526,1366,606
33,0344-6782/2021-06-21/08/0344-6782_2021-06-21T08-34-22Z.jpg,521,CONFIG002,6,0,0.8963629007339478,daisy,88,84,1336,639,1424,723
33,0344-6782/2021-06-21/08/0344-6782_2021-06-21T08-34-22Z.jpg,521,CONFIG002,7,0,0.8958624601364136,daisy,89,78,1194,348,1283,426
33,0344-6782/2021-06-21/08/0344-6782_2021-06-21T08-34-22Z.jpg,521,CONFIG002,8,0,0.8928661346435547,daisy,82,78,807,611,889,689
33,0344-6782/2021-06-21/08/0344-6782_2021-06-21T08-34-22Z.jpg,521,CONFIG002,9,0,0.8893022537231445,daisy,93,85,1142,541,1235,626
33,0344-6782/2021-06-21/08/0344-6782_2021-06-21T08-34-22Z.jpg,521,CONFIG002,10,0,0.8878200054168701,daisy,98,97,1229,623,1327,720
33,0344-6782/2021-06-21/08/0344-6782_2021-06-21T08-34-22Z.jpg,521,CONFIG002,11,0,0.8856688737869263,daisy,86,92,1140,922,1226,1014
33,0344-6782/2021-06-21/08/0344-6782_2021-06-21T08-34-22Z.jpg,521,CONFIG002,12,0,0.883882999420166,daisy,81,80,860,889,941,969
33,0344-6782/2021-06-21/08/0344-6782_2021-06-21T08-34-22Z.jpg,521,CONFIG002,13,0,0.8815778493881226,daisy,87,82,1408,651,1495,733
33,0344-6782/2021-06-21/08/0344-6782_2021-06-21T08-34-22Z.jpg,521,CONFIG002,14,0,0.8740034103393555,daisy,81,84,1224,251,1305,335
33,0344-6782/2021-06-21/08/0344-6782_2021-06-21T08-34-22Z.jpg,521,CONFIG002,15,0,0.8728803396224976,daisy,97,105,1388,956,1485,1061
33,0344-6782/2021-06-21/08/0344-6782_2021-06-21T08-34-22Z.jpg,521,CONFIG002,16,0,0.8664150834083557,daisy,82,100,965,963,1047,1063
33,0344-6782/2021-06-21/08/0344-6782_2021-06-21T08-34-22Z.jpg,521,CONFIG002,17,0,0.8521894812583923,daisy,70,65,1219,406,1289,471
33,0344-6782/2021-06-21/08/0344-6782_2021-06-21T08-34-22Z.jpg,521,CONFIG002,18,0,0.8444938063621521,daisy,85,90,882,838,967,928
33,0344-6782/2021-06-21/08/0344-6782_2021-06-21T08-34-22Z.jpg,521,CONFIG002,19,0,0.8366973400115967,daisy,67,64,1019,688,1086,752
33,0344-6782/2021-06-21/08/0344-6782_2021-06-21T08-34-22Z.jpg,521,CONFIG002,20,0,0.8257237672805786,daisy,69,81,1133,603,1202,684
33,0344-6782/2021-06-21/08/0344-6782_2021-06-21T08-34-22Z.jpg,521,CONFIG002,21,0,0.8114413022994995,daisy,91,87,1145,432,1236,519
33,0344-6782/2021-06-21/08/0344-6782_2021-06-21T08-34-22Z.jpg,521,CONFIG002,22,0,0.809573233127594,daisy,73,76,1088,614,1161,690
33,0344-6782/2021-06-21/08/0344-6782_2021-06-21T08-34-22Z.jpg,521,CONFIG002,23,0,0.5884085893630981,daisy,65,71,1225,858,1290,929
